ёбург	ˈjo̞bʊrɡʲɪ
абаба	ɐˈbäbɨ
абрам	ʌˈbram
абубакир	ɐbʊbɐˈkʲir
авдей	avˈdʲɛj
авзония	ɐˈvz̪onʲɪɪ
аврора	ɐˈvrorə
аган	ɐˈɡɑn
адвент	ɐd̪ˈvʲen̪t̪ɨ
адель	ɐˈd̪ɛlʲ
адонис	ɐˈd̪onʲɪs̪ɐd̪ɐˈnʲis̪
азраил	ɐz̪rɐˈiɫɨ
аким	ɐˈkʲimɨ
алан	ɐˈɫan̪ɨ
александр	ɐlʲɪˈksandr
алешковский	ɐlʲɪˈʂko̞fs̪kʲɪɪ
алиса	ɐˈlʲisɨ
алтай	ɐɫˈtaj
альбион	ɐlʲbʲɪˈon̪ɨ
альгамбра	ɐlʲˈɡambrə
алёна	ɐˈlʲɵnɨ
амфитрион	ɐmfʲɪt̪rʲɪˈon̪
анапа	ɐˈnɑpə
анатольевич	ənɐˈtolʲjɪvʲɪʨɪ
андрей	anˈdrʲej
анды	ˈɑndɨ
антанта	ɐn̪ˈt̪an̪t̪ɨ
антон	ɐn̪ˈt̪on̪
анюков	ɐnʲʉˈkofɐnʲʉˈkovə
апокалипсис	ɐpɐˈkalʲɪpsʲɪsɨ
арагви	ɐˈragvʲɪ
арей	ɐˈrɛi
арес	ɐˈrɛsɨ
арлекин	ɐrlʲɪˈkʲinɨ
артищев	ɐrˈtʲiɕːɪvɨ
артём	ɐrˈtʲɵmɨ
архип	ɐɾˈxʲip
асланбий	ɐs̪ɫɐn̪ˈbʲiɪ̯
асланджерий	ɐs̪ɫən̪d̪ʐɨˈrʲiɪ̯
ахиллес	ɐxʲɪˈlʲesɨ
байкал	bɐɪ̯ˈkaɫ̪
балаклава	bəɫ̪ɐˈkɫ̪ävɨ
бармаглот	b601rm652712glot
бахус	ˈbaxʊs̪ɨ
бедлам	bʲɪd̪ˈɫ̪ämɨ
берёзовая	bʲɪˈrʲɵzəvəjə
бирма	ˈbʲirmɨ
бог	ˈbox
братислава	brɐtʲisɫavɨ
британия	brʲɪˈt̪änʲɪɪ̯ə
вавилон	vəvʲɪˈɫon
вадим	vɐˈdʲimɨ
ванька	ˈvänʲkʲɪ
варвара	vɐrˈvarə
варуна	vɐˈrʊnə
васька	ˈväsʲkə
веда	ˈvʲed̪ə
венера	vʲɪˈnʲerɨ
вера	ˈvʲerə
весы	vʲɪˈsɨ
википедия	vʲɪkʲɪˈpʲedʲɪjə
викисловарь:инкубатор/логан	ˈɫogan
викисловарь:инкубатор/вещина	vʲeˈɕːna
викисловарь:инкубатор/глумёж	ɡɫ̪ʊˈmʲɵʂ
викисловарь:инкубатор/кита	ˈkʲitə
викисловарь:инкубатор/колять	kolʲatʲ
викисловарь:инкубатор/коржак	koŕjaki
викисловарь:инкубатор/маус	maus
викисловарь:инкубатор/псакинг	ˈpsakʲɪngʲɪ
владимир	vlɐˈdʲimʲirɨ
волчиха	vɐlˈt͡ɕixʲɪ
воля	ˈvolʲə
всеволодович	ˈfvsʲevəɫ̪əd̪əvʲɪt͡ɕ
вулкан	vʊɫˈkan̪ɨ
вы	vɨ
выборг	ˈvɨbərx
гацир	ɡɐˈt͡sɨr
георгиевск	ɡʲɪor	ɡʲɪjevsk
герцеговина	gsupjsuprcgəˈvsupjsupinə
глеб	ˈɡlʲɛbɨ
голяк	ɡɐˈlʲak
дворжак	ˈdvorʐək
демиург	dʲɪmʲɪˈurk
диомид	dʲɪɐˈmʲit
дичь	dʲit͡ɕ
евгений	jɪvˈgʲenʲɪj
европа	jɪvˈropɨ
егор	jɪˈgor
ереван	jɪrʲɪˈvan
ерофей	ɪ̯jɪrɐˈfʲeɪ̯
земля	ˈzʲemlʲɪ
изменчивый	ɪˈzmʲenʲt͡ɕɪvɨjə
иордан	ɪɐrˈdan
казань	kɐˈzanʲ
казбек	kɐsˈbʲekʲɪ
кит	kʲɪt
клондайк	kɫɐnˈdaɪ̯kʲɪ
кола	ˈkoɫ̪ə
колян	kɐˈlʲæn
компас	ˈkompəsɨ
константин	kənstɐnʲˈtʲin
констанция	kənˈstɐntsɪjɪ
коран	kɐˈranɨ
коринка	kɐˈrʲinkə
костян	kɐˈsʲtʲæn
кошурников	kɐˈʂurnʲɪkəf
краснодар	krɐsnɐˈdaɾ
крым	krɨm
ксения	ˈksʲenʲɪː
кубань	kʊˈbanʲ
кузьма	kʊzʲˈma
кума	kʊˈma
кура	kʊˈra
кыров	ˈkɨrəvɨ
лажа	ˈɫ̪aʐə
лев	lʲef
лекс	ˈlʲeksɨ
лиза	ˈlʲiz̪ɨ
лина	ˈɫʲinɨ
липецк	ˈlʲipʲɪtsk
лист	lʲist
лондон	ˈlondən
луна	ɫʊˈna
львов	lʲvof
мид	ˈmʲidɨ
майка	ˈmaɪ̯kʲɪ
максим	mɐkˈsʲim
малая	ˈmalɨjə
маня	ˈmanʲə
марс	ˈmarsɨ
мартын	mɐrˈtɨn
масленица	ˈmas̪lʲɪnʲɪt͡sə
мата	ˈmat̪əɨ
матвей	mɐt̬ˈvʲeɪ
матвейчук	mɐt̬vʲejt͡ɕʊˈkʲi
медведев	mʲɪd̪ˈvʲedʲɪfmʲɪd̪ˈvʲedʲɪvə
микола	mʲɪˈkoɫɨ
мила	ˈmʲiɫə
михаил	mʲɪxɐˈiɫɨ
михайло	mʲɪˈxajɫə
михась	ˈmʲɪˈxəsʲ
миша	ˈmʲiʂɨ
монстрация	mɐn̪ˈs̪t̪rät͡sɨɪ̯ə
мошков	mɐʂˈkovɨ
мурзик	ˈmurzʲɪk
мурманск	ˈmurmənsk
мухосранск	mʊxɐˈs̪ran̪s̪k
мшага	ˈmʂaɡʲɪ
мыкола	mɨˈkoɫɨ
нем	ˈnʲemɨ
нептун	nʲɪpˈtunɨ
ник	ˈnʲikʲɪ
никки	ˈnʲɪkkɪ
николаевич	nʲɪkɐˈɫaɪvʲɪtɕɪ
николай	nʲɪkɐˈɫaj
норма	ˈnormə
нью-йорк	njʊˈjɵrkʲɪ
об	ˈobɨ
обена	əbʲɪˈna
обь	opʲ
одесса	ɐˈdʲesːɨ
ока	ɐˈka
оксана	ɐkˈsanɨ
ольга	ˈolʲɡə
ос	os̪
павел	ˈpavʲɪl
павлович	ˈpavɫəvʲɪt͡ɕɪ
пацин	ˈpatsɨn
петрович	pʲɪtˈrovʲɪtɕ
петрозаводск	pʲɪtrəzɐˈvotsk
пиндосия	pʲɪn̪ˈd̪osʲɪɪ̯ɪ
плутон	pɫʊˈton
погребной	pəɡrʲɪbˈnoɪ̯
пола	ˈpo̞ɫə
почка	ˈpoʨkə
примаков	prʲɪmɐˈkovɨ
псалтирь	psɐɫˈtiɾʲɪ
псалтырь	psɐɫˈtɨɾʲɪ
рахметов	rɐxˈmʲetəf
рубинштейн	rʉbʲɪnˈʨtɛjn
рыбная	ˈrɨbn̪əɪ̯ə
сайкин	ˈsajkʲɪnɨ
самара	sɐˈmarə
саня	ˈs̪anʲə
саранск	sɐˈransk
сарма	s̪ɐrˈma
сатурн	sɐˈturn
саша	ˈs̪äʂɨ
свислочь	ˈs̪vis̪ɫ̪ət͡ɕ
сергеевич	sʲɪrˈɡʲeɪvʲɪt͡ɕɪ
сергей	sʲɪrˈgʲɛjɪ
серов	sʲɪˈrovɨ
сечь	sʲet͡ɕ
снегурочка	snʲɪˈgurətɕkʲɪ
совфед	s̪ɐˈfʲːet̪
солнце	ˈsontsə
соник	ˈsonʲɪk
союз	sʌˈjus
ставрополь	ˈstavrəpəlʲɪ
станислава	stənʲɪˈsɫavɨ
сура	sʊˈra
сёма	ˈsʲɵmə
тамань	tɐˈmanʲ
тамара	tɐˈmarɨ
тамбовщина	tɐmˈbofɕːɪnə
тесаков	tʲɪsɐˈkovɨ
тина	ˈtʲinə
тойма	ˈtojmɨ
труд	t̪rut̪
турция	ˈturtsɪjə
тыва	tɨˈva
украина	ʊkrɐˈinɨ
украинка	ʊkrˈainkʲɪ
уран	ʊˈranɨ
федя	ˈfʲedʲə
фейсбук	ˈfeɪsˌbʊk
фома	fɐˈmɨ
хадж	ˈxad̪ʐɨ
холодная	xɐˈlodnəjə
хопёр	xɐˈpʲo̞ɾ
челябинск	t͡ɕɪˈlʲäbʲɪn̪s̪k
червяк	t͡ɕɪrvʲɪˈkʲi
черенков	t͡ɕɪrʲɪnˈkɔvɨ
черепаха	ʨɪrʲɪˈpaxə
чечня	ʨɪʨˈnʲæ
шайтан	ʂɐjˈtan
шарапов	ʂʌˈrapəvɨ
ы	ɨ
эбола	ɛˈbo̞ɫ̪ə
эдвард	ˈɛdvərt
эйяфьядлайёкюдль	ɛɪ̯ˈäfʲɪ̯əd̪ɫ̪əɪ̯ɵkʲʉd̪lʲɪ
ю	jʉ
юпитер	jʉˈpʲitʲər
юрий	ˈjurʲɪ
юрьевич	ˈjurʲjɪvʲɪtɕɪ
яким	jɐˈkʲim
абаец	ɐˈbäɪt͡s
абажур	əbɐˈʐur
абазин	ɐbɐˈzʲinɨ
аббатиса	ɐbɐˈtʲisɨɐbːɐˈtʲisɨ
аббатство	ɐˈbat͡stvəɐˈbːat͡stvə
аббревиатура	əbrʲɪvʲɪɐˈturɨ
абдуктор	ɐbˈduktər
абевега	ɐbʲɪˈvʲegə
абессив	əbʲɪˈsːif
абецедарий	ɐbᵻt͡sᵻˈdarʲɪ
абилитация	ɐbʲɪlʲɪˈtat͡sɨɪ̯ə
абитур	ɐbʲɪˈturɨ
абитура	ɐbʲɪˈt̪urə
аболиционист	əbəlʲɪt͡sɨɐˈnʲistɨ
абракадабра	əbrəkɐˈdabrɨ
абрек	ɐˈbrʲekʲɪ
абрикос	ɐbrʲɪˈkosɨ
абрикотин	abrikoˈtin
абрис	ˈabrʲɪsɨ
абруптив	əbrʊˈptʲif
абсорбент	əpsɐrˈbʲent
абстракт	ɐpˈstraktɨ
абстяга	ɐpˈsʲtʲæɡʲɪ
абстяк	ɐpˈsʲtʲak
абхазец	ɐpˈxazʲɪts
абыз	ɐˈbɨs̪
ав	ˈaf
ава	ˈavə
аванзал	ɐvɐnˈzɑɫ
аванзала	ɐvɐn̪ˈz̪aɫɨ
аванпост	ɐvɐn̪ˈpostɨ
авантаж	ɐvɐn̪ˈt̪aʐɨ
авантюра	ɐvɐn̪ˈtʲʉ̞rə
авантюрист	ɐvɐn̪tʲʊˈrʲis̪t̪
аварийка	ɐvɐˈrʲiɪ̯kə
аватар	ɐvɐˈtar
аватарка	ɐvɐˈtarkʲɪ
август	ˈɑvgʊstɨ
авеню	əvʲɪˈnʲʉ
авиабуй	ɐvʲɪəˈbuɪ̯
авиавооружение	ˌɐvʲəvɐɐrʊˈʐɛnʲɪə
авиакрейсер	ˌavʲɪɐˈkrejsʲər
авиалиния	əvʲɪɐˈlʲinʲɪjə
авианавигация	ˌavʲɪənəvʲɪˈgat͡sɨjə
авиатор	əvʲɪˈatərɨ
авиз	ɐˈvʲis̪
авишка	ɐˈvʲiʂkʲɪ
авишник	ɐˈvʲiʂnʲɪk
авран	ɐˈvran̪
аврора	ɐˈvrorə
австерия	ɐfˈs̪t̪ɛrʲɪjə
автобиография	əftəbʲɪɐˈgrafʲɪjɪ
автобусник	ɐfˈt̪o̞bʊs̪nʲɪk
автовокзал	ˌɐftəvɐgˈzɑɫ
автогир	ɐft̪ɐˈɡʲir
автогол	ˌɐftəgɐˈɫɨ
автожир	əftɐˈʐɨr
автократия	əftɐˈkratʲɪjɪ
автоперевод	ˌɑftəpʲɪrʲɪˈvodɨ
автопортрет	ɐftəpʌɾˈtrʲɛt
авторица	ˈaftərʲɪt͡sɨ
авторша	ˈaftərʂɨ
авторынок	əftɐˈrɨnək
автосмесь	ɐft̪ɐˈs̪mʲesʲ
автостарт	ɐft̪ɐˈs̪t̪art̪
автострада	ɐftɐˈstradə
автотюн	əftɐˈtʲunɨəftɐˈtʲjunɨ
автоугон	ɐft̪əuˈɡon̪ɨ
авточасть	əftɐˈt͡ʃasʲtʲ
агамия	əɡɐˈmʲijə
агатис	ɐˈɡatʲɪs̪
агглютинин	ɐgːlʲʊtʲɪˈnʲin̪
агент	ɐˈgʲent
агентесса	ɐɡʲɪn̪ˈt̪ɛs̪ːə
агентство	aˈgʲɛntstvɒ
агиасма	ɐɡʲɪˈas̪mə
агиология	əgʲɪɐˈɫogʲɪː
агитвагон	ɐˌɡʲit̪vɐˈɡon̪ɨ
агломерат	ɐɡɫ̪əmʲɪˈrät̪
агнец	ˈaɡnʲɪt͡s
агон	ɐˈɡo̞n̪
агония	ɐˈɡonʲɪɪ
агора	ɐɡɐˈrɨ
аграрник	ɐˈgrarnʲɪkʲɪ
агрегация	əgrʲɪˈgɑtsɨɪ
агрегирование	əgrʲɪˈgʲirəvənʲɪjə
агропропаганда	ˌaɡrəprəpɐˈɡan̪d̪ɨ
агрохимик	ˌagrɐˈxʲimʲɪk
агул	ɐˈɡul
агути	ɐˈɡutʲɪ
адамант	ɐd̪ɐˈman̪t̪
адамашка	ɐd̪ɐˈmaʂkʲɪ
адвент	ɐd̪ˈvʲen̪t̪ɨ
адвокатишка	ɐd̪vɐˈkatʲɪʂkə
аденозинтрифосфат	ədɛnəˌzʲintrʲɪfɐsˈfat
адессив	ədɨˈsʲːɪf
адех	ɐˈdʲex
админ	ɐdˈmʲinɨ
администратор	ədmʲɪnʲɪˈstratərɨ
адонис	ɐˈd̪onʲɪs̪ɨ
адрес	ˈadrʲɪs
адрес-календарь	ˌɐd̪rʲɪskəlʲɪn̪ˈd̪arʲ
адресуемость	ədrʲɪˈsuɪməsʲtʲɪ
адряс	ɐˈd̪rʲas̪
адсорбент	ətsɐrˈbʲebtɨ
адъективация	ɐdʲɪ̯ɪktʲɪˈvat͡sɨɪ
адъюнкт	ɐˈdʲjʉ̞nkt
адъюнктура	ɐdʲjʉ̞nkˈturə
адъютант	ɐdʲjʉˈt̪an̪t̪ɨ
адъютантик	ɐdʲjʉ̞ˈt̪an̪tʲɪkʲɪ
ажиотаж	əʐɨɐˈtɑʐɨ
аз	ɐˈzɨ
азат	ɐˈz̪at̪ɨ
азбука	ˈazbʊkʲɪ
азиат	əzʲɪˈɑtɨ
азиатчина	əzʲɪˈat͡ɕːɪnɨ
азик	ˈazʲɪk
азимут	ˈazʲɪmʊt
азотобактер	ɐˌzotɐˈbaktʲɪr
аил	ɐˈil
аист	ˈaistɨ
айва	ɐjˈva
айкидо	ˌɐjkʲɪˈdo
айпишник	ɐɪ̯ˈpʲiʂnʲɪk
академия	ɐkɐˈdʲemʲɪɪ̯ə
академка	əkɐˈdʲemkʲɪ
акафистник	ɐˈkafʲɪsʲnʲɪk
акация	ɐˈkatsɨjə
акварель	ɐkvɐˈrʲelʲ
аквариум	ɐkˈvarʲɪʊm
аквацикл	əkvɐˈt͡sɨkɫ
аквилегия	əkvʲɪˈlʲegʲɪjə
аквилон	ɐkvʲɪˈɫon̪ɨ
аккорд	ɐˈkort
аккордеон	ɐkərdʲɪˈonɨ
аккузатив	əkʊzɐˈtʲif
аккумулятор	akːʊmʊˈlʲætərɨ
акробат	akrɒˈbatɨ
акробатизм	ɐkrəbɐˈtʲiz̪mɨ
акростих	ɐkrɐˈsʲtʲixʲɪ
аксамит	ɐˈks̪amʲɪt̪
акселератор	ʌksʲɪlʲɪˈratər
акселерация	əksʲɪlʲɪˈrat͡sɨjə
аксельбант	ɐksʲɪlʲˈban̪t̪
аксиология	əksʲɪɐˈɫoɡʲɪjə
актант	ɐkˈtantɨ
активация	əktʲɪˈvat͡sɨɪ
активист	əktʲɪˈvʲistɨ
актинограф	ɐktʲɪˈn̪oɡrəf
актиноид	əktʲɪˈnoɪt
актинометр	əktʲɪˈnomʲɪtər
актомиозин	ɐkt̪əmʲɪɐˈzʲin̪ɨ
актриска	ɐkˈt̪rʲis̪kə
актуализатор	ɐkt̪ʊɐlʲɪˈz̪at̪ərɨ
актёрка	ɐˈktʲɵrkʲɪ
акула	ɐˈkuɫɨ
акула-кошка	ɐˈkuɫəˈkoʂkə
акупрессура	ɐkʊprʲɪˈsːurə
акупунктура	əkʊpʊnˈktuɾɨ
акустика	ɐˈkusʲtʲɪkə
акушер	əkʊˈʂɛr
акцентология	əkt͡sɛntɐˈɫogʲɪjə
акцепт	ɐkˈt͡sɛpt
акциз	ɐkˈt͡sɨzɨ
акцизник	ɐkˈt͡sɨzʲnʲɪkʲɪ
акционирование	əkt͡sɨɐˈnʲirəvənʲɪjə
акын	ɐˈkɨnɨ
алан	ɐˈɫan
аларм	ɐˈɫarmɨ
албанец	ɐɫˈbɑntsɨ
алгвазил	ɐɫɡvɐˈzʲiɫɨ
алгебра	ˈaɫgʲɪbrə
алгорифм	əɫgɐˈrʲifm
алебарда	ɐlʲɪˈbard̪ə
алебастр	əlʲɪˈbast̻rɨ
александрийка	ɐlʲɪksɐn̪ˈd̪rʲijkə
аликант	ɐlʲɪˈkan̪t̪
алканол	əɫkɐˈnoɫɨ
алкатель	ɐɫˈkatʲɪlʲ
алкаш	ɐɫ̪kəˈʂɨ
алкашка	ɐɫˈkaʂkʲɪ
алкин	ɐɫˈkʲɪn
алкион	ɐɫkʲɪˈon̪ɨ
алкоголизм	əɫkəgɐˈlʲizmɨ
алкоголичка	aɫkəgoˈɬɪtʃʲkʲɪ
аллегорика	ɐlʲɪˈɡorʲɪkʲɪ
аллигаторша	əlʲɪˈgɑtərʂɨ
аллоген	əɫːɐˈgʲen
алломорф	ɐlːɐˈmorf
алломорфа	ɐlːɐˈmorfə
аллонж	ɐˈlonʂ
аллоним	ɐɫːɐˈnʲim
аллопат	ɐlːɐˈpatɨ
аллопатия	ɐlːɐˈpatʲɪɪ
аллофона	ɐɫɐˈfon̪ə
алмазец	ɐɫˈmazʲɪt͡s
алмазник	ɐlˈmazʲnʲɪk
алмазчик	ɐɫˈmaɕːɪkʲɪ
алодей	ɐlɐˈdʲej
алодея	ɐlɐˈdʲejə
алой	ɐˈɫoɪ̯
алопеция	əɫɐˈpʲet͡sɨɨ
алтан	ɐɫˈt̪an̪
алтын	ɐɫ̪ˈt̪ɨn̪ɨ
алтынчик	ɐɫˈt̪ɨnʲt͡ɕɪk
алфавит	ɐɫfɐˈvʲitɨ
алхимик	ɐɫˈxʲimʲɪkʲɪ
алхимист	ɐɫxʲɪˈmʲis̪t̪ɨ
алырник	ɐˈɫɨrnʲɪkʲɪ
альбаака	əlʲbʌˈʌkʲɪ
альбатрос	əlʲbɐˈtrosɨ
альбигоец	əlʲbʲɪˈgoɪt͡s
альбомец	ɐlʲˈbomʲɪt͡s
альбум	ɐlʲˈbumɨ
альгвасил	ɐlʲɡvɐˈsʲiɫ
альграфия	ɐlʲˈɡrafʲɪɪ
альдолаза	ɐlʲd̪ɐˈɫaz̪ə
альдоль	ɐlʲˈd̪olʲ
альдрованда	ɐlʲd̪rɐˈvan̪d̪ə
алькад	ɐlʲˈkalʲd̪ɨ
алькаидовец	ɐlʲˈkaid̪əvʲɪt͡s
алькальд	ʌlʲˈkalʲdɨ̞
алькасар	ɐlʲkɐˈs̪arɨ
альменда	ɐlʲˈmʲen̪d̪ə
альпинизм	əlʲpʲɪˈnʲizmɨ
альпинист	ɐlʲpʲɪˈnʲis̪t̪ɨ
альтиграф	ɐlʲtʲɪˈɡrafɨ
альтинг	ˈalʲtʲɪŋk
альфа	ˈalʲfɨ
аляповатость	əlʲɪpɐˈvɑtəsʲtʲ
аманат	ɐmɐˈn̪at̪
аманта	ɐˈman̪t̪ə
амбал	ɐmˈbaɫ̪ɨ
амбарец	ɐmˈbart͡sɨ
амбарик	ɐmˈbarʲɪkʲɪ
амбиграмма	əmbʲɪˈgramːə
амбидекстрия	ɐmbɪˈdʲeks̪t̪rʲɪɪ̯ɪ
амбициозность	əmbʲɪtsəˈoznəsʲtʲ
амбициозный	əmbʲɪtsəˈoznɨj
амбоцептор	ɐmbɐˈt͡sɛptər
амбушюр	ɐmbʊˈʂurɨ
амвон	ɐmˈvo̞nɨ̞
американочка	ɐmʲrʲɪˈkan̪ət͡ɕkə
америкос	əmʲɪrʲɪˈkosɨ
аметист	əmʲɪ̝ˈtʲist
амиант	ɐmʲɪˈan̪t̪ɨ
амигдалит	ɐmʲɪɡd̪ɐˈlʲit̪ɨ
амимия	ɐmʲɪˈmʲiɪ̯ə
аминазин	əmʲɪnɐˈzʲin
аминогруппа	əmʲɪnɐˈgrupːə
аминодонт	ɐmʲɪnɐˈdontɨ
аммиак	ɐmʲɪˈak
аммонал	ɐmːɐˈnalɨ
аммоний	ɐˈmːonʲɪɪ̯
аммофос	ɐmɐˈfos
ампер	ɐmˈpʲer
ампир	ɐmʲˈpʲir
ампутант	ɐmpʊˈtantɨ
амуниция	ɐmʊˈnʲit͡sɨjə
амуничник	ɐmʊˈnʲit͡ɕnʲɪkʲɪ
амурчик	ɐˈmurt͡ɕɪkʲɪ
амфитрион	ɐmfʲɪt̪rʲɪˈon̪
амфодонт	ɐmfɐˈdont
амфодонтоз	ɐmfədɐnˈtozɨ
амфора	ˈamfərə
амёба	ɐˈmʲɵbə
анабиоз	ənəbʲɪˈozɨ
анал	ɐˈn̪ɑɫ̪ɨ
аналав	ɐn̪ɐˈɫavɨ
анализатор	ənəlʲɪˈzatər
аналист	ɐn̪ɐˈlʲis̪t̪ɨ
аналогий	ɐnɐˈlogʲɪj
анальгетик	ənɐlʲˈgʲetʲɪk
ананасик	ɐn̪ɐˈn̪asʲɪk
анапест	ɐˈnapʲɪst
анархо-	əˈnarxə
анатомик	ɐn̪ɐˈt̪omʲɪk
анатомирование	ənətɐˈmʲirəvənʲɪje
анафема	ɐˈnafʲɪmə
анафорез	ənəfɐˈrɛzɨ
анахорет	ɐn̪əxɐˈrʲet̪
анахоретка	ɐn̪əxɐˈrʲet̪kʲɪ
анбар	ɐn̪ˈbarɨ
ангар	ɐnˈɡar
ангина	ɐn̪ˈɡʲin̪ə
ангиома	ɐnɡʲɪˈomɨ
англез	ɐŋˈɡlʲes
английский	ɐnˈɡlʲiɪ̯skʲɪɪ̯
англиканец	ən̻glʲɪˈkant͡sɨ
англиканство	ənglʲɪˈkɑnstvə
англичанин	əŋglʲɪˈtɕænʲɪ
англоман	ən̻gɫɐˈmanɨ
англофильство	ɐn̪gɫ̪ɐˈfʲilʲs̪t̪və
андалузка	ɐndɐˈluskʲɪ
андийка	ɐnʲˈdʲiɪ̯kə
андроним	ɐn̪ˈd̪ronʲɪm
андроповка	ɐnˈdropəfkʲɪ
анекдот	ɐnʲɪˈɡdot
анемия	ənʲɪˈmʲijə
анилин	ənʲɪˈlʲinɨ
анилингус	ənʲɪˈlʲingʊs
анималистка	ɐnʲɪmɐˈlʲis̪t̪kʲɪ
анион	ənʲɪˈon
анкерок	ɐn̪kʲɪˈrok
аннигиляция	ɐnʲːɪɡʲɪˈlʲat͡sɨɪ̯ə
аннуитет	ɐnʊiˈtʲetɨ
аномал	ɐnɐˈmalɨ
анонимщик	ənɐˈnʲimɕɪkʲɪ
анонс	ɐˈnonsɨ
аноректик	ɐnɐˈrɛktʲɪk
ант	an̪t̪
антал	ˈan̪t̪əɫɨ
антанагога	ɐn̪t̪ən̪ɐˈɡoɡə
антидепрессант	ˌɐnʲtʲɪdʲɪprʲɪˈsant
антидор	ɐnʲtʲɪˈd̪orɨ
антик	ɐn̪ˈtʲik
антиклимакс	ɐnʲtʲˈklʲiməks̪ɨ
антикоммунист	ənʲtʲɪkəmʊˈnʲistɨ
антикрыло	antiˈkrɨlʲjə
антипат	ɐnʲtʲɪˈpat̪
антирринум	ɐnʲtʲɪˈrʲinʊmɨ
антистатик	ənʲtʲɪˈstatʲɪk
антиутопия	ənʲtʲɪʊˈtopʲɪjə
антифашизм	ənʲtʲɪfɐˈʂɨzm
антифашист	ənʲtʲɪfɐˈʂɨstɨ
античастица	ənʲtʲɪtɕɪˈsʲtʲitsə
антоним	ɐnˈtonʲɪmɨ
антоциан	ɐn̪t̪ət͡sɨˈan̪ɨ
антрекот	ɐntrʲɪˈkotɨ
антресоль	ɐntrʲɪˈsolʲ
антропоид	ɐntrɐˈpoɪdɨ
антрополог	əntrɐˈpoɫəgʲɪ
антропоморфизм	əntrəpəmɐrˈfʲizmɨ
анус	ˈanʊs
анфилада	ənfʲɪˈladɨ̞
аншлаг	ɐnˈʂlakʰ
аорист	ɐˈorʲɪstɨ
апатит	əpʌˈtʲit
апатрид	ɐpɐtˈɾʲit
апач	ɐˈpaʨɪ
апачка	ɐˈpat͡ɕkʲɪ
апаш	ɐˈpaʂ
апельсин	ɐpʲɪlʲˈsʲin̪
апертура	əpʲɪrˈturə
аплодирование	əplʌˈdʲirəvənʲɪ̝jɪ
апломб	ɐpˈɫombɨ
апокриф	ɐˈpokrɪf
аппаратчик	əpɐˈraʨːɪk
аппендикс	ɐˈpʲenʲdʲɪks
аппликатура	əplʲɪkɐˈturɨ
аптека	ɐpˈtʲekə
араб	ɐˈrabɨ
арабеска	ərɐˈbʲeskə
арабист	ərɐˈbʲist
арама	ɐˈramɨ
арамейка	ɐrɐˈmʲeɪ̯kə
арап	ɐˈrapɨ
арапка	ɐˈrapkʲɪ
арапник	ɐˈrapnʲɪkʲɪ
арапчик	ɐˈrapt͡ɕɪkʲɪ
арафатка	ɐrɐˈfatkʲɪ
арбалет	ərbɐˈlʲet
арбитраж	ərbʲɪtˈraʐɨ
арбуз	ɐrˈbuzɨ
аргамак	ɐrɡɐˈmakʲɪ
аред	ˈarʲɪt̪
арека	ɐˈrʲekə
арестант	ɐrʲɪˈstant
арестантка	ɐrʲɪˈstantkə
арестантская	ɐrʲɪˈstanskʲɪɪ
ариец	ɐˈrʲijɪts
арий	ˈarʲɪɪ
аристарх	ɐrʲɪˈs̪t̪arx
аристократизм	ɐrʲɪs̪t̪əkrɐˈtʲiz̪mɨ
аристократишка	ərʲɪstɐˈkratʲɪʂkə
арифметик	ɐrʲɪfˈmʲetʲɪk
арифметика	ɐrʲɪfˈmʲetʲɪkʲɪ
арканзас	ɐrkɐn̪ˈz̪as̪ɨ
арматура	ərmɐˈturə
арменист	ərmʲɪˈnʲist
армия	ˈarmʲɪː
армяк	ɐrmʲɪˈkʲi
армянин	ərmʲɪˈnʲin
армянка	ɐrˈmʲænkʲɪ
армячишко	ɐrmʲɪˈt͡ɕiʂkə
армячок	ɐrmʲɪˈt͡ɕki
арнаутка	ɐrn̪ɐˈut̪kə
арт	ˈart̪ɨ
артритик	ɐrˈt̪rʲitʲɪkʲɪ
артритичка	ɐrt̪rʲɪˈtʲit͡ɕkə
арфа	ˈarfə
арфянка	ɐrˈfʲan̪kʲɪ
архаизм	ɐrxɐˈizmɨ
архаика	ɐrˈxäɪkʲɪ
архаичность	ərxɐˈiʨnəsʲtʲ
архалук	ɐrxɐˈɫuk
архангел	ɐrˈxanɡʲɪɫɨ
архаровец	ʌrˈxarəftsɨ
архивист	ərxʲɪˈvʲistɨ
архимагир	ɐrxʲɪmɐˈɡʲirɨ
архимандрит	ərxʲɪmɐndˈrʲit
архимандрития	ɐrxʲɪmɐn̪d̪ˈrʲitʲɪɪ̯ə
архимандритство	ɐrxʲɪmɐn̪d̪ˈrʲit͡stvə
архипиздрит	ˌɐrxʲɪpʲɪz̪ˈd̪rʲit̪
архисинагог	ɐrxʲɪsʲɪn̪ɐˈɡok
архитектон	ɐrxʲɪtʲɪkˈt̪on̪
архитекторша	ɐrxʲɪˈtʲekt̪ərʂɨ
архитриклин	ɐrxʲɪt̪rʲɪˈklʲin̪
арчинец	ɐrˈt͡ʃinʲɪt͡s
арчинка	arˈt͡ʃinkə
аршин	ɐrˈʂɨn̪
аршинник	ɐrˈʂɨnːkʲɪ
асана	ɐˈsanə
асессор	ɐˈsʲesər
асессорство	ɐˈsʲes̪ərs̪t̪və
асидол	ɐsʲɪˈd̪oɫ
асимптота	ɐˈsʲimptətəɐsʲɪmpˈtotə
асимптотика	əsʲɪmptˈotʲɪkə
аскетизм	əskʲɪˈtʲizmɨ
аскос	ɐˈskos
аспид	ˈaspʲɪdɨ
ассорти	əsɐrˈtʲi
астеник	ɐˈstɛnʲɪkʲɪ
астма	ˈastmə
астролябия	əstrɐˈlʲæbʲɪjə
астрономия	əstrɐˈnɔmʲijə
асфальтировщица	ɐs̪fəlʲtʲɪˈrofɕɪt͡sə
асфиксия	əsfʲɪkˈsʲiɪː
асьенто	ɐsʲˈjentə
ат	ˈatɨ
атайка	ɐˈt̪aɪ̯kə
атаман	ətɐˈmɑn
атараксия	ətɐˈraksʲɪjə
атлатль	ˈat̪ɫət̪lʲɪ
атомист	ɐt̪ɐˈmʲis̪t̪
атомка	ˈat̪əmkə
аттестат	ɐtʲɪˈstatɨ
аттестация	ətʲesˈtatsɨjə
атторней	gemy
аудитория	ɐʊdʲɪˈt̪orʲɪɪ̯ə
аукуба	ɐuˈkubɨ
аул	aˈuɫ
аутист	ɐuˈtʲis̪t̪ɨ
аутолиз	ɐʊˈt̪olʲɪs
аутопсия	ˌɐʊtɐˈpsʲiɪ
аутсорсинг	əʊtˈsorsʲɪnk
афганец	ɐˈvganʲtsɨ
аферюга	ɐfʲɪˈrʲʉ̞ɡʲɪ
афробит	ɐfrɐˈbʲit̪ɨ
аффидавит	əfʲɪdɐˈvʲit
ахан	ɐˈxan̪ɨ
ахвахец	ɐxˈvaxt͡sɨ
ахвахка	ɐxˈvaxkʲɪ
ахинея	ɐxʲɪˈnʲeɪ̯ə
ахнарик	ɐˈxn̪arʲɪk
ахтунг	ˈaχtʊngʲɪ
ахуй	ˈaxʊɪ̯jɪ
ахулиард	ɐxʊlʲɪˈard̪ɨ
ахун	ɐˈxun̪ɨ
ацетат	ət͡sɨˈtatɨ
ацефалия	ət͡sɛˈfalʲɪː
ашкеназ	əʂkʲɪˈnazɨ
аэрокарта	ˈkartɨ
аэрология	ˌaɪ̯rɐˈɫogʲɪ
аэроплан	əɨrɐˈplanɨ
аэропресс	ˌɐɛrɐˈprɛs
баба	ˈbabə
баббит	bɐˈbʲitɨ
бабочник	ˈbabəʨnʲɪk
бабушка	ˈbabʊʂkə
баггинг	ˈbaɡʲɪŋɡʲɪ
багет	bɐˈgʲet
багорик	bɐˈɡorʲɪk
багорчик	bɐˈɡort͡ɕɪk
багрянник	bɐˈɡrʲænʲːɪk
бадминтон	bədmʲɪnˈtonɨ
бадминтонист	bədmʲɪntɐˈnʲistɨ
бадминтонистка	bəd̪mʲɪn̪t̪ɐˈnʲis̪t̪kʲɪ
бадья	bɐˈdʲji
базарник	bɐˈzarnʲɪk
базидиомицет	bəzʲɪdʲɪəmʲɪˈt͡sɛtɨ
байбак	bəjbɐˈkʲi
байбачина	bəɪ̯bɐˈt͡ɕin̪ə
байдарка	bɐjˈdɑrkə
байдарочник	bɐɪ̯ˈd̪arət͡ɕnʲɪkʲɪ
байдарочница	bɐɪ̯ˈd̪arət͡ɕnʲɪt͡sə
байк	ˈbaɪ̯kʲɪ
байкал	bɐɪ̯ˈkaɫ̪
байрам	bɐɪ̯ˈramɨ
бакалея	bəkɐˈlʲejɪ
бакенбарда	bɐkʲɪnˈbardɐ
баклага	bɐkˈɫagə
баклажан	bəkɫɐˈʐan̪ɨ
баклан	bɐkˈɫanɨ
баклуша	bɐˈkluʂə
бактериолог	bəktɛrʲɪˈoɫək
бактериология	bəktɛrʲɪɐˈɫogʲɪː
бактерицид	bəktɛrʲɪˈt͡sɨt
бактриан	bəktrʲɪˈanɨ
бакун	bɐˈkun̪ɨ
балабон	bəɫɐˈbon̪ɨ
балаган	bəlɐˈgan
балагур	bəlɐˈgur
балагурка	bəɫɐˈɡurkʲɪ
балагурство	ˌbɐlɐˈgurstvə
балаклава	bəɫ̪ɐˈkɫ̪ävɨ
балалаечка	bəɫɐˈɫaɪ̯t͡ɕkə
балалайка	bəɫɐˈɫajkə
баламут	bəɫɐˈmutɨ
баланда	bɐˈɫ̪än̪d̪ɨ
балансир	bəɫɐnˈsʲir
балансировщик	bəɫən̻sʲɪˈrofɕːɪk
баларужина	bɐɫ̪ɐˈruʐɨn̪ə
балахон	bəɫɐˈxonɨ
балахонник	bəɫɐˈxonʲɪk
балахончик	bəɫɐˈxonʲt͡ɕɪkʲɪ
балбера	bɐɫˈbʲerə
балдахин	bəɫdɐˈxʲinɨ
балдж	ˈbalt͡ʂʂ
балет	bɐˈlʲet̪
балетчица	bɐˈlʲeɗ̥t͡ɕɪt͡sɨ
балканист	bəɫkɐˈnʲistɨ
балкар	bɐɫˈkɑrɨ
балкарец	bɐɫˈkɑrtsɨ
баллиста	bɐˈlʲis̪t̪ə
баллистокардиография	bɐˌlis̪t̪əkərdʲɪɐˈɡrafʲɪɪ
балльник	ˈbalʲnʲɪkʲɪ
баловень	ˈbaɫəvnʲɪ
балочка	ˈbaɫət͡ɕkʲɪ
балтизм	bɐɫˈtʲiz̪mɨ
бальнеология	bəlʲnʲɪɐˈɫogʲɪjə
балюстрада	bəlʲʊsˈtradə
баляса	bɐˈlʲasə
балясник	bɐˈlʲæsʲnʲɪkʲɪ
бамовец	ˈbäməvʲɪt͡s
бан	ˈban̪ɨ
банан	bɐˈn̪an̪
бананоед	bənənɐˈjet
бангладешец	bən̻gɫɐˈdɛʂt͡sɨ
бандарша	ˈbɑndɑrʂɨ
бандеровец	bɐn̪ˈd̪ɛrəvʲɪt͡sbɐn̪ˈdʲerəvʲɪt͡s
бандеровка	bɐnˈdɛrəfkʲɪ
бандерша	ˈbɑndɛrʂɨ
бандо	bɐnˈdo̞
бандократия	bən̪d̪ɐˈkrätʲɪɪ̯ə
бандола	bɐnˈdolɨ
бандюга	bɐnʲˈdʲʉ̞ɡə
бандюк	bənʲdʲʉˈki
банкаброшница	bən̪kɐˈbroʂnʲɪt͡sə
банкир	bɐnˈkʲirɨ
банкнота	bɐnkˈnotɨ
банкоброш	bənkɐˈbroʂ
банковец	ˈban̪kəvʲɪt͡s
банкрот	bɐnˈkrotɨ
банкёр	bɐn̪ˈkʲɵr
бант	bɑn̻t
банту	ˈban̻tʊ
банчик	ˈbanʲt͡ɕɪkʲɪ
банчишко	bɐnʲˈt͡ɕiʂkʲɪ
банчок	bɐnʲˈt͡ɕok
баобаб	bɐːˈbap
баптизм	bɐpˈtʲizmɨ
баптистерий	bəptʲɪˈstɛrʲɪɪ̯
бара	ˈbarɨ
барабанщик	bərɐˈbɑnʲɕːɪk
барабошка	bərɐˈboʂkə
баран	bɐˈran
баранинка	bɐˈranʲɪn̪kʲɪ
баранка	bɐˈran̻kʲɪ
бараночка	bɐˈran̪ət͡ɕkʲɪ
барбадосец	bərbɐˈdost͡sɨ
барбамил	bərbɐˈmʲiɫɨ
барбарис	bərbɐˈrʲis
барвинок	bɐrˈvʲinək
баргузин	bərgʊˈzʲinɨ
бард	bart
бардак	bɐrˈdak
барельефчик	bərʲɪˈlʲjeft͡ɕɪkʲɪ
баржонка	bɐrˈʐon̪kʲɪ
барий	ˈbärʲɪɪ̯
баринок	bərʲɪˈn̪ok
барион	bərʲɪˈon
барисфера	bərʲɪˈs⁽ʲ⁾fʲerə
баритончик	bərʲɪˈt̪onʲt͡ɕɪk
барка	ˈbarkʲɪ
баркасик	bɐrˈkasʲɪkʲɪ
барнаулка	bərn̪ɐˈuɫkə
барограф	bɐˈroɡrəfɨ
барометрия	bərəmʲɪtˈrʲij
баронство	bɐˈron̻stvə
барофункция	bərɐˈfunkt͡sɨɪ
барочка	ˈbarət͡ɕkʲɪ
барриль	ˈbarʲɪlʲɪ
барство	ˈbarstvə
барсук	bərsʊˈkʲɨ
барсучок	bərs̪ʊˈt͡ɕok
барыга	bɐˈrɨɡʲɪ
барыш	bɐˈrɨʂ
барышник	bɐˈrɨʂnʲɪkʲɪ
барышничество	bɐˈrɨʂnʲɪʨɪstvə
барьеристка	bərʲjɪˈrʲis̪t̪kə
басист	bɐˈsʲis̪t̪
басистость	bɐˈsʲis̪t̪əsʲtʲɪ
баска	ˈbäs̪kə
баскетбол	bəskʲɪtˈboɫɨ
баскинья	bɐˈs̪kʲinʲjɪ
басконка	bɐˈs̪kon̪kʲɪ
баснописец	bəsnɐˈpʲistsɨ
баснь	ˈbasʲnʲɪ
басня	ˈbɑsʲnʲɪ
басовитость	bəs̪ɐˈvʲit̪əsʲtʲ
басорама	bɐsɐˈramə
басота	bɐˈs̪o̞t̪ɨ
бассейн	gemy
баталист	bətɐˈlʲistɨ
баталёр	bət̪ɐˈlʲɵrɨ
батенька	ˈbatʲɪnʲkʲɪ
батик	ˈbɑtʲɪk
батман	bɐtˈmanɨ
батожник	bɐˈt̪oʐnʲɪkʲɪ
батрак	bɐˈt̪rak
батрачина	bɐˈt̪rat͡ɕɪn̪ə
батуд	bɐˈt̪ut̪
батька	ˈbatʲkʲɪ
баурсак	bəʊrˈsak
бафтинг	ˈbɑftʲɪnk
баханье	ˈbaxənʲɪ̯ə
бахарь	ˈbaxərʲ
бахвал	bɐˈxvaɫɨ
бахилка	bɐˈxʲiɫkə
бахта	bɐxˈt̪a
башенка	ˈbaʂɨnkə
башкан	bɐʂˈkanɨ
башлык	bəʂɫɨˈkʲi
башмачник	bɐʂˈmat͡ɕnʲɪkʲɪ
башня	ˈbaʂnʲə
баюканье	bɐˈjʉ̞kənʲjə
баян	bɐˈjæn̪ɨ
баянистка	bəjɐˈnʲis̪t̪kʲɪ
бдын	ˈbd̪ɨn̪ɨ
бебехи	ˈbʲebʲɪxʲɪbʲɪˈbʲexʲɪ
бебут	ˈbʲebʊtɨ
беглец	bʲɪɣˈlʲɪˈtsɨ
беглянка	bʲɪˈglʲankʲɪ
бегун	bʲɪˈgun
бегунок	bʲɪgʊnˈkʲi
беда	bʲɪˈda
бедж	bɛt͡ʃ
бедка	ˈbʲet̪kʲɪ
бедлам	bʲɪd̪ˈɫ̪ämɨ
бедняжечка	bʲɪd̪ˈnʲaʐɨt͡ɕkə
беднячка	bʲɪd̪ˈnʲæt͡ɕkʲɪ
бедуин	bʲɪdʉˈinɨ
беженец	ˈbʲeʐɨn̪t͡sɨ
безбожник	bʲesˈboʐnʲɪk
безводица	bʲɪz̪ˈvodʲɪt͡sə
безвозбранность	bʲɪz̪vɐz̪ˈbran̪ːəsʲtʲɪ
безвольность	bʲɪz̪ˈvolʲn̪əsʲtʲɪ
безвременье	bʲəzˈvrʲemʲɪnʲjə
безвыгодность	bʲɪz̪ˈvɨɡəd̪n̪əsʲtʲ
безглагольность	bʲɪz̪ɡɫɐˈɡolʲn̪əsʲtʲɪ
безглагольство	bʲɪz̪ɡɫɐˈɡolʲs̪t̪və
безгласие	bʲɪˈz̪ɡɫasʲɪjə
безграмотство	bʲɪz̪ˈɡramət͡st̪və
безгрешность	bʲɪzˈgrʲeʂnəsʲtʲɪ
безделица	bʲɪ̝ˈzʲdʲelʲɪ̟tsə
безделушечка	bʲɪzʲdʲɪˈɫuʂɨt͡ɕkə
бездельник	bʲɪzʲˈdʲelʲnʲɪk
бездельничанье	bʲɪˈzʲdʲelʲnʲɪt͡ɕənʲjɪ
бездождье	bʲɪˈz̪d̪oʐdʲjəbʲɪˈz̪d̪oʑːjə
бездолье	bʲɪˈz̪d̪olʲjɪ
бездомница	bʲɪˈz̪d̪omnʲɪt͡sɨ
бездомный	bʲɪzˈdomnɨj
бездомовник	bʲɪz̪d̪ɐˈmovnʲɪk
бездомовница	bʲɪz̪d̪ɐˈmovnʲɪt͡sɨ
бездомье	bʲɪˈz̪d̪omʲjə
бездонье	bʲɪˈz̪d̪onʲjɪ
бездорожица	bʲɪz̪d̪ɐˈroʐɨt͡sɨ
бездорожье	bʲəzdɐˈroʐjə
бездумье	bʲɪˈz̪d̪umʲjə
бездуховность	bʲɪzdʊˈxovnəsʲtʲ
бездымка	bʲɪz̪ˈd̪ɨmkə
бездыханный	bʲɪzdɨˈxanɨj
безжалостность	bʲɪzˈʐaɫəstnəsʲtʲ
беззаконник	bʲɪz̪ːɐˈkonʲːɪkʲɪ
беззаконница	bʲɪz̪ːɐˈkonʲːɪt͡sə
безземелье	bʲɪzʲːɪˈmʲelʲjɪ
безик	ˈbʲezʲɪkbʲɪˈzʲik
безлесье	bʲɪz̪ˈlʲesʲjɪ
безлюдность	bʲɪz̪ˈlʲʉ̞d̪n̪əsʲtʲ
безматок	bʲɪz̪ˈmat̪kʲɪ
безмолвность	bʲɪz̪ˈmoɫvn̪əsʲtʲɪ
безмотивность	bʲɪz̪mɐˈtʲivn̪əsʲtʲ
безнаказанность	bʲznɐˈkazənːəsʲtʲɪ
безнал	bʲɪzˈnaɫ
безопасность	bʲɪzɐˈpasnəsʲtʲ
безоружность	bʲɪz̪ɐˈruʐn̪əsʲtʲ
безотвязность	bʲɪz̪ɐt̪ˈvʲaz̪n̪əsʲtʲɪ
безразличие	bʲɪzrɐzˈlʲiʨɪjə
безрогость	bʲɪz̪ˈroɡəsʲtʲ
безрыбица	bʲɪz̪ˈrɨbʲɪt͡sɨ
безумность	bʲɪˈz̪umn̪əsʲtʲ
безумолчность	bʲɪz̪ʊˈmoɫt͡ɕn̪əsʲtʲ
безупречность	bʲɪzʊˈprʲeʨnəsʲtʲɪ
безурядица	bʲɪz̪ʊˈrʲædʲɪt͡sɨ
безусадочность	bʲɪz̪ʊˈs̪ad̪ət͡ɕn̪əsʲtʲɪ
безусый	bʲɪˈzusɨj
бей	bʲej
бейгл	ˈbʲeɪ̯gɫ
бейдж	bɛɪ̯t͡ʃ
бейсболист	bʲɪjzbɐˈlʲistɨ
бейсболистка	bʲɪɪ̯z̪bɐˈlʲis̪t̪kʲɪ
бейсболка	bʲɪɪ̯ˈzbolkə
бекасёнок	bʲɪkɐˈsʲɵn̪ək
бекон	bʲɪˈko̞n
белемнит	bʲɪlʲɪmˈnʲit
белена	bʲɪlʲɪˈna
бели	ˈbʲelʲɪ
белила	bʲɪˈlʲiɫə
белобилетник	ˌbʲeɫəbʲɪˈlʲetnʲɪk
белобрысость	bʲɪɫɐˈbrɨs̪əsʲtʲ
белодушка	bʲɪɫɐˈd̪uʂkʲɪ
белоземец	bʲɪɫɐˈzʲemʲɪt͡s
белокурость	bʲɪɫɐˈkurəsʲtʲɪ
белопашец	bʲɪɫɐˈpaʂt͡sɨ
белоподкладочник	bʲɪɫəpɐt̪ˈkɫad̪ət͡ɕnʲɪkʲɪ
белорус	bʲɪɫɐˈrusɨ
белорыбица	bʲɪɫɐˈrɨbʲɪt͡sə
белость	ˈbʲeɫəsʲtʲ
белуга	bʲɪˈɫugə
белужинка	bʲɪˈɫuʐɪn̪kə
белужка	bʲɪˈɫuʂkʲɪ
бельевщица	bʲɪlʲjɪfˈɕit͡sə
бельище	bʲɪˈlʲjiɕːə
бельмо	bʲɪlʲˈmo
бельчонок	bʲɪlʲˈt͡ɕatə
беляна	bʲɪˈlʲan̪ɨ
беляночка	bʲɪˈlʲan̪ət͡ɕkə
беляш	bʲɪlʲɪˈʂɨ
белёсость	bʲɪˈlʲɵs̪əsʲtʲɪ
бенефициар	bʲenʲfʲɪt͡sɨˈar
бензинчик	bʲɪnʲˈzʲinʲt͡ɕɪkʲɪ
бербер	bʲɪrˈbʲer
бердан	bʲɪrˈd̪an̪
бердана	bʲɪrˈd̪an̪ɨ
береговушка	bʲɪrʲɪɡɐˈvuʂkə
бережение	bʲɪrʲɪˈʐɛnʲɪɪ̯ə
бережочек	bʲɪrʲɪˈʐot͡ɕɪk
бережь	ˈbʲerʲɪʐɨ
березина	bʲɪˈrʲezʲɪn̪ɨ
березит	bʲɪrʲɪˈzʲit̪
березник	bʲɪˈrʲezʲnʲɪk
березничек	bʲɪˈrʲezʲnʲɪt͡ɕkʲɪ
берейтор	bʲɪˈrʲeɪ̯t̪ər
берека	bʲɪˈrʲekə
беремечко	bʲɪˈrʲemʲɪt͡ɕkʲɪ
берендейка	bʲɪrʲɪnʲˈdʲeɪ̯kə
бересклет	bʲɪrʲɪs̪kˈlʲet̪ɨ
берестина	bʲɪrʲɪˈsʲtʲin̪ə
берлин	bʲɪrˈlʲin̪ɨ
берлина	bʲɪrˈlʲin̪ə
берсальер	bʲɪrs̪ɐˈlʲjer
берёза	bʲiˈrʲɵzə
берёзка	bʲɪˈrʲɵskə
берёзонька	bʲɪˈrʲɵz̪ənʲkʲɪ
берёстка	bʲɪˈrʲɵs̪t̪kʲɪ
беседчик	bʲɪˈsʲeɗ̥ʲt͡ɕɪkʲɪ
бесклассовость	bʲɪˈs̪kɫas̪əvəsʲtʲɪ
бескормица	bʲɪˈs̪kormʲɪt͡sɨ
бескормщина	bʲɪˈs̪kormɕːɪn̪ə
бескорыстие	bʲɪskɐˈrɨsʲtʲɪjə
бескрайность	bʲɪs̪ˈkraɪ̯n̪əsʲtʲɪ
беспамятство	bʲɪsˈpamʲɪtstvə
беспаспортность	bʲɪˈs̪pas̪pərt̪n̪əsʲtʲɪ
бесподобность	bʲɪs̪pɐˈd̪obn̪əsʲtʲ
беспомощность	bʲsˈpoməɕːnəsʲtʲ
беспорядица	bʲɪs̪pɐˈrʲædʲɪt͡sɨ
беспочвенность	bʲɪsˈpot͡ɕvʲɪnːəsʲtʲɪ
беспрекословие	bʲɪs̪prʲɪkɐˈs̪ɫovʲɪɪ̯ə
бесприветность	bʲɪs̪prʲɪˈvʲet̪n̪əsʲtʲɪ
беспристрастный	bʲəsprʲɪˈstrasnɨjə
беспробудность	bʲɪs̪prɐˈbud̪n̪əsʲtʲɪ
беспросыпность	bʲɪs̪prɐˈs̪ɨpn̪əsʲtʲ
беспутие	bʲɪs̪ˈput̪ʲɪɪ̯jə
бесследность	bʲɪˈs̪ːlʲed̪n̪əsʲtʲ
бессловесный	bʲɪssɫɐvʲesnɨj
бессодержательность	bʲɪsːədʲɪrˈʐatʲɪlʲnəsʲtʲ
бесстрашность	bʲɪˈs̪ːt̪raʂn̪əsʲtʲɪ
бесталанность	bʲɪstɐˈɫɑnːəsʲtʲ
бестиарий	bʲɪsʲtʲɪˈarʲɪː
бестолковка	bʲɪstɐɫˈkofkə
бестолковье	bʲɪs̪t̪ɐɫˈkovʲjɪ
бестолочь	ˈbʲes̪t̪əɫ̪ət͡ɕ
бесцельность	bʲɪsˈtsɛlʲnəsʲtʲ
бета-лучи	ˈbɛt̪əɫʊˈt͡ɕi
бета-частица	ˈbʲetət͡ɕɪˈsʲtʲit͡sɨ
бечёвка	bʲɪˈʨɵfkʲɪ
бешмет	bʲɪˈʂmʲet̪
бздун	bz̪d̪ʊˈn̪ɨ
бздунья	ˈbz̪d̪unʲɪ̯ə
бздюха	ˈbzʲdʲʉ̞xʲɪ
бздюшка	ˈbzʲdʲʉ̞ʂkʲɪ
бздёх	bzʲdʲɵx
библиотека	bʲɪblʲɪɐˈtʲekə
бивак	bʲɪˈvakʲɪ
бивуак	bʲɪvʊˈakʲɪ
бигос	ˈbʲigəsɨ
бизнес-форум	ˌbʲiznɛsˈforʊm
бизнесменство	bʲɪz̪n̪ɨˈs̪mʲen̪s̪t̪və
бикгед	ˈbʲikɡɛdɨ
билборд	bʲɪlˈbordɨ
билет	bʲɪˈlʲet
билингва	bʲɪˈlʲingvə
било	ˈbʲiɫ̪ə
бинтовка	bʲɪn̪ˈt̪ofkʲɪ
биогенез	ˌbʲɪəgʲɪˈnɛs
биограф	bʲɪˈogrəf
биодобавка	bʲɪədɐˈbafkə
биология	bʲɪɐˈɫoɡʲɪjə
биометрия	bʲɪɐˈmʲetrʲɪːbʲɪəmʲɪtˈrʲiɪ
бионт	bʲɪˈontɨ
биоритм	bʲɪɐˈrʲit̻mɨ
биоробот	bʲɪɐˈrobətɨ
биоток	bʲɪɐˈto̞kʲɪ
биплан	bʲɪˈpɫanɨ
бирка	ˈbʲirkʲɪ
бисер	ˈbʲisʲɪr
биткойн	bitkɔɪns
битл	bʲɪˈt͡lɨ
бичёвник	bʲɪˈt͡ɕo̞vnʲɪkʲɪ
благодеяние	bɫəgədʲɪˈjænʲɪjə
благонравность	bɫəɡɐˈn̪ravn̪əsʲtʲ
благообразие	bɫ̪əɡəɐbˈräzʲɪɪ̯ə
благостыня	bɫəɡɐˈs̪t̪ɨnʲə
благотворительность	bləgɐtvɐˈrʲitʲɪlʲnosʲtʲɪ
блажь	bɫ̪äʂ
бланбек	bɫɐn̪ˈbʲekʲɪ
бластома	bɫɐˈs̪t̪omə
блатмейстер	bɫɐt̪ˈmʲeɪ̯sʲtʲɪr
блатняк	bɫɐt̻ˈnʲæk
блато	ˈbɫat̪ə
близнята	blʲɪˈzʲnʲat̪ə
близняшка	blʲɪˈzʲnʲaʂkə
блиндажик	blʲɪn̪ˈd̪aʐɨk
блинец	blʲɪˈnʲet͡s
блинница	ˈblʲinʲːɪt͡sɨ
блокада	bɫɐˈkadɨ
блокировка	bɫəkʲɪˈrofkə
блонда	ˈbɫon̪d̪ɨ
блондин	bɫɐnˈdʲin
блондиночка	bɫɐnʲˈdʲin̪ət͡ɕkə
блуд	bɫut
блудень	ˈbludʲɪnʲ
блудня	ˈbɫudʲnʲɪ
блузка	ˈbɫuskʲɪ
блузник	ˈbɫuzʲnʲɪkʲɪ
блюдо	ˈblʲudə
блюминг	ˈblʲʉmʲɪn̻k
блядки	ˈblʲät̪kʲɪ
блядёшка	blʲɪˈdʲɵʂkə
бобыль	bɐˈbɨlʲ
бог	ˈboɡʲɪ
богадельня	bəgɐˈdʲelʲnʲɪ
богатейка	bəɡɐˈtʲeɪ̯kə
богатырка	bəgɐˈtɨrkə
богатырша	bəɡɐˈt̪ɨrʂə
богачество	bɐˈɡat͡ɕɪs̪t̪və
богохульство	bəɡɐˈxulʲstvɐ
богочеловек	bəgət͡ɕɪɫɐˈvʲek
бодунья	bɐˈd̪unʲɪ̯ɪ
боженька	ˈboʐɪnʲkə
бозон	bɐˈzonɨ
бойкот	bɐɪ̯ˈkot
боковуша	bəkɐˈvuʂɨ
боксёрша	bɐkˈsʲɵrʂə
болван	bɐɫ̪ˈvän̪ɨ
болванка	bɐlˈvankʲɪ
болвашка	bɐɫˈvaʂkʲɪ
болгарин	bɐɫˈgarʲɪn
болезнетворность	bəlʲɪzʲnʲɪˈt̪vorn̪əsʲtʲɪ
болесть	ˈbolʲɪsʲtʲbɐˈlʲesʲtʲ
боливиец	bəlʲɪˈvʲiɪt͡s
болотинка	bɐˈɫotʲɪn̪kə
болт	bɐɫ̪ˈt̪ɨ
большевицкий	bəlʲʂɨˈvʲit͡skʲɪɪ̯
бомбардир	bəmbɐrˈdʲir
бомбер	ˈbombʲɪrɨ
бомбила	bɐmˈbʲiɫə
бомжара	bɐmˈʐarə
бонсай	bɐnˈsaɪ
борей	bɐˈrʲej
борзятник	bɐrˈzʲætʲnʲɪkʲɪ
борий	ˈborʲɪj
бормотунья	bərmɐˈt̪unʲjə
боровик	bɐrɐvʲɪˈkʲi
борода	bərɐˈda
бородавочка	bərɐˈd̪avət͡ɕkʲɪ
борозда	bərɐˈzda
бороздование	bərəz̪d̪ɐˈvanʲɪɪ̯ə
борок	bɐrˈkʲi
боронка	bɐˈron̪kə
бороновка	bərɐˈn̪ofkə
борсетка	bɐrˈsʲetkə
борт	bɐrˈtä
бортник	ˈbort̻n̻ʲɪkʲɪ
бортпроводник	bortprəvədnʲɪˈkʲi
борчиха	bɐrˈt͡ɕixə
босанова	bəsʌˈno̞və
боскет	bʌˈskʲɛt
босовик	bəs̪ɐˈvʲik
бостон	bɐˈs̪t̪on̪
босяк	bəsʲɪˈkʲi
ботало	ˈbo̞t̪əɫ̪əbɐˈt̪aɫ̪ə
ботан	bɐˈt̪än̪
ботаничка	bət̪ɐˈnʲit͡ɕkʲɪ
ботик	ˈbotʲɪkʲɪ
ботинок	bɐˈtʲinkʲɪ
ботфорт	bɐt̪ˈfort̪
ботфорта	bɐt̪ˈfort̪ɨ
боцман	ˈbotsmən
бочка	ˈbotɕkʲɪ
бочок	bɐˈʨɵk
бочонок	bɐˈʨɵnkʲɪ
бошняк	bɐʂˈnʲæk
боязнь	bɐˈjæzʲɪnʲɪ
боярышник	bɐˈjærɨʂnʲɪk
боярышня	bɐˈjarɨʂnʲə
брабансон	brəbɐn̪ˈs̪on̪ɨ
бравура	brɐˈvurɨ
брада	brɐˈd̪ɨ
бразда	brɐˈzda
бразильянец	brəzʲɪˈlʲjan̪t͡sɨ
брак	ˈbrakʲɪ
брандахлыст	brən̪d̪ɐˈxɫ̪ɨs̪t̪ɨ
брандмайор	ˌbran̪t̪mɐˈjorɨ
бранч	ˈbranʲt͡ɕɪ
браслет	brɐˈslʲet
братаниха	brɐˈt̪änʲɪxə
брателла	brɐˈt̪ɛɫ̪ːɨ
братик	ˈbrätʲɪk
братишка	brɐˈtʲiʂkʲɪ
братоубийство	brɐtəʊˈbʲijstvə
братоубийца	brɐtəʊˈbʲijtsɨ
братушка	ˈbrat̪ʊʂkəbrɐˈt̪uʂkə
браунинг	ˈbraʊnʲɪngʲɪ
бревёшко	brʲɪˈvʲɵʂkə
брегет	brʲɪˈɡʲet̪
брезг	brʲes̪k
брезгуша	brʲɪˈz̪ɡuʂɨ
брезент	brʲɪˈzʲentɨ
бренный	ˈbrʲɛnɨj
бреньканье	ˈbrʲenʲkənʲɪ̯ɪ
бретёр	brʲɪˈtʲɵr
брешь	ˈbrʲeʂɨ
бригадир-наставник	brʲɪɡɐˈdʲirnɐˈstavnʲɪk
бригадмил	brʲɪɡɐd̪ˈmʲiɫɨ
бригадмилец	brʲɪɡɐd̪ˈmʲilʲt͡sɨ
бригадница	brʲɪˈɡadʲnʲɪt͡sɨ
бригантина	brʲɪgɐnʲˈtʲinɨ
брика	ˈbrʲikə
бриль	ˈbrʲilʲɪ
бриошь	brʲɪˈo̞ʂɨ
брит-поп	brʲɪt̪ˈpop
бритьё	brʲɪˈtʲjɵ
бричка	ˈbrʲit͡ɕkʲɪ
брод	ˈbro̞d̪ɨ
бродяжка	brɐˈdʲaʂkʲɪ
брокат	brɐˈkat̪
брошь	ˈbro̞ʂɨ
брудерация	brʊd̪ɨˈrat͡sɨɪ̯ə
брускетта	brʊˈskʲetɨ
брусника	brʊsʲˈnʲikə
брусница	brʊˈsʲnʲit͡sə
брусок	brʊˈs̪o̞k
брусочник	brʊˈs̪ot͡ɕnʲɪkʲɪ
брутальный	brʊˈtalʲnɨj
брызгун	brɨz̪ɡʊˈn̪ɨ
брыкун	brɨˈkun̪
брюзглость	ˈbrʲʉ̞z̪ɡɫəsʲtʲɪ
брюнетка	brʉˈnʲɛtkə
брют	ˈbrʲʉ̞t̪ɨ
брюхан	brʉˈxan
брюхач	brʲʊxɐˈt͡ɕi
брюхо	ˈbrʲʉxʲɪ
бряк	brʲak
бряканье	ˈbrʲakənʲɪ̯ɪ
брёх	ˈbrʲɵxʲɪ
бубен	ˈbubɪn
бубенчик	bʊˈbʲenʲʨɪkʲɪ
буби	ˈbubʲɪ
бублик	ˈbublʲɪk
бубличек	ˈbublʲɪt͡ɕkʲɪ
бубличник	ˈbublʲɪt͡ɕnʲɪkʲɪ
бубличница	ˈbublʲɪt͡ɕnʲɪt͡sɨ
бубновка	bʊbˈn̪ofkʲɪ
бубны	ˈbubnɨ
буддизация	bʊdʲːɪˈz̪ät͡sɨɪ̯ə
буддист	gemy
буддолог	gemy
будорага	bʊd̪ɐˈraɡə
будочник	ˈbud̪əs̪nʲɪkʲɪ
будра	ˈbud̪rə
будяк	bʊˈdʲak
будёновка	bʊˈdʲɵnəfkʲɪ
буженина	bʊʐɨˈnʲinə
буженинка	bʊʐɨˈnʲin̪kʲɪ
бузила	bʊˈzʲiɫə
бузотёрство	bʊz̪ɐˈtʲɵrs̪t̪və
буйвол	ˈbujvəɫɨ
буйство	ˈbujstvə
букан	bʊˈkan̪ɨ
букетец	bʊˈkʲetʲɪt͡s
буколька	ˈbukəlʲkə
буксир	bʊkˈsʲr
булава	bʊɫɐˈva
булавочник	bʊˈɫavəʂnʲɪk
булавочница	bʊˈɫavət͡ɕnʲɪt͡sɨ
булдыган	bʊɫd̪ɨˈɡan̪ɨ
булка	ˈbuɫkʲɪ
булла	gemy
булочка	ˈbulɐʨkʲɪ
булочная	ˈbuɫəʨnɨjə
бульварность	bʊlʲˈvarn̪əsʲtʲ
бульдозерист	bʊlʲd̪əzʲɪˈrʲis̪t̪ɨ
бумагомарака	bʊˌmaɡəmɐˈrakʲɪ
бумагомарательство	bʊməgəmɐˈratʲɪlʲstvə
бумагопрядильня	bʊˌmaɡəprʲɪˈdʲilʲnʲə
бумажник	bʊˈmaʐnʲɪkʲɪ
бумазея	bʊmɐˈzʲeɪ
бумбокс	bʊmˈboks̪ɨ
бундес	ˈbun̪d̪əsɨ
бункеровщик	bʊn̪kʲɪˈrofɕɪkʲɪ
бунтарь	bʊn̪t̪ɐˈrʲi
бунтовство	bʊn̪t̪ɐfˈs̪t̪va
бунтовщик	bʊn̪t̪əfɕːɪˈkʲi
бунчужный	bʊn̪ˈt͡ɕuʐn̪ɨj
бунчук	bʊn̪t͡ɕʊˈkʲi
бурак	bʊrɐˈkʲi
буран	bʊˈran
бурат	bʊˈrat̪ɨ
бурбон	bʊrˈbonɨ
бургер	ˈburgʲɪrɨ
бурда	bʊrˈd̪ɨ
буревал	bʊrʲɪˈvaɫɨ
бурелом	bʊrʲɪˈɫomɨ
буржуй	bʊrˈʐuj
буржуйка	bʊrˈʐujkə
бурка	ˈburkə
бурлак	bʊrˈɫ̪ak
бурмистр	bʊrˈmʲis̪t̪r
бурнус	bʊrˈn̪us̪
бурнусик	bʊrˈn̪usʲɪkʲɪ
бурса	ˈburs̪ɨ
бурч	burt͡ɕ
бурш	burʂ
бурёнушка	bʊˈrʲɵn̪ʊʂkʲɪ
бус	bus̪
буссоль	bʊˈso̞lʲɪ
бусы	ˈbusɨ
бутада	bʊˈt̪ad̪ɨ
бутафор	bʊtɐˈforɨ
бутафория	bʊtɐˈforʲɪjə
бутер	ˈbutʲɪrɨ
бутоньерка	bʊtʌnʲˈjɛ̝rkʲɪ
буфетец	bʊˈfʲeɗ̥t͡sɨ
буфетик	bʊˈfʲetʲɪk
буханка	bʊˈxankə
буханочка	bʊˈxanɐʨkə
бухарник	bʊˈxarnʲɪk
бухта	ˈbuxtə
буча	ˈbut͡ɕʲə
бушизм	bʊˈʂɨzmɨ
бывалость	bɨˈvaɫəsʲtʲ
былина	bɨˈlʲinɨ
былинушка	bɨˈlʲin̪ʊʂkʲɪ
былка	ˈbɨɫkə
быль	bɨlʲ
быстрорастворимый	bɨstrəɾəstvɐˈɾʲimɨjɪ
быстряк	bɨs̪t̪rʲɪˈkʲi
быстрянка	bɨˈs̪t̪rʲan̪kʲɪ
бытовщина	bɨt̪ɐfˈɕːin̪ə
бычок	bɨ̞ˈt͡ɕkʲi
бычонок	bɨˈt͡ɕɵn̪ək
бьюик	ˈbʲjʉ̞ikʲɪ
бэк-вокал	ˌbɛkvɐˈkaɫɨ
бэк-вокалист	ˌbɛkvəkɐˈlʲis̪t̪ɨ
бэк-вокалистка	ˌbɛkvəkɐˈlʲis̪t̪kʲɪ
бэкграунд	bɛɡːˈräʊn̪t̪
бэкслеш	bɛkˈs̪ɫɛʂɨ
бювар	bʲʊˈvar
бюргер	ˈbʲʉrgʲɪr
бяшка	ˈbʲaʂkə
вавилонянин	vəvʲɪˈɫonʲɪnʲɪ
вагант	vɐˈɡan̪t̪ɨ
вагон-хоппер	vɐˈgo̞n̪ˈxo̞pːɪr
вагонка	vɐˈgonkə
вагоновожатый	vɐˌɡonəvɐˈʐatɨɪ̯
вазелин	vəzʲɪˈlʲinɨ
вазопись	ˈvazəpʲɪsʲɪ
вай-фай	vɐɪ̯ˈfaɪ
вакса	ˈvaksə
вакханалия	vəkxɐˈnalʲɪː
вакханка	vɐkˈxɑnkə
валеж	vɐˈlʲeʂ
валенец	ˈvalʲɪn̪t͡sɨ
валенок	ˈvalʲɪn̪ək
валентность	vɐˈlʲentnəsʲtʲɪ
валерьяна	vəlʲɪˈrʲjanɨ
валидность	vɐˈlʲid̻nəsʲtʲɪ
вализа	vɐˈlʲiz̪ə
валлиец	vɐˈlʲːijɪt͡s
валторна	vɐɫˈtornɨ
валун	vəɫʊˈnɨ
валух	ˈvaɫʊxvɐˈɫux
валушок	vəɫʊˈʂok
вальтрап	vɐlʲˈt̪rap
валюта	vɐˈlʲʉ̞tɨ
валютка	vɐˈlʲʉ̞tkə
валютница	vɐˈlʲʉ̞tʲnʲɪt͡sə
валютоносность	vəlʲʉ̞tɐˈnosnəsʲtʲɪ
валютоёмкость	vəlʲʉ̞tɐˈjɵmkəsʲtʲɪ
валёр	vɐˈlʲɵrɨ
вампир	vɐmʲˈpʲir
вампиресса	vəmʲpʲɪˈrɛsːɨ
вампиризм	vəmʲpʲɪˈrʲizmɨ
вампириха	vɐmʲˈpʲirʲɪxə
вампирка	vɐmʲˈpʲirkə
вампирша	vɐmʲˈpʲirʂɨ
вампука	vɐmˈpukə
вампум	ˈvampʊm
ванадий	vɐˈnadʲɪɪ
ваниль	vɐˈnʲilʲɪ
ванна	vanːɨ
ванта	ˈvantə
варан	vɐˈranɨ
варвар	ˈvarvərɨ
варварка	ˈvarvərkʲɪ
варенье	vɐˈrʲenʲjə
вариант	vərʲɪˈant
варильщица	vɐˈrʲilʲɕɪt͡sɨ
вариометр	vərʲɪˈomʲɪtrɨ
варначка	vɐrˈn̪at͡ɕkə
варрант	vɐˈrːant
варяг	vɐˈrʲæk
варёнка	vɐˈrʲɵnkə
василёк	vəsʲɪˈlʲo̞k
василёчек	vəsʲɪˈlʲɵt͡ɕkʲɪ
васисдас	vəs̪ɨˈz̪d̪as̪ɨ
ватажок	vət̪ɐˈʂkʲi
ватерполист	vətɛrpɐˈlʲist
ватка	ˈvät̪kʲɪ
ваточка	ˈvät̪ət͡ɕkə
ватруха	vɐˈt̪ruxʲɪ
вахман	ˈvaxmən̪ɨ
вахмистр	ˈvaxmʲɪs̪t̪r
вахтпарад	ˌvaxtpɐˈrat
ваш	vaʂˈvaʂɪˈvaʂə
вварка	ˈvːarkʲɪ
вводка	ˈvːot̪kə
вгон	vɡon̪
вдавлинка	ˈvd̪avlʲɪn̪kə
вдова	vdɐˈva
вдовка	ˈvd̪ofkə
вдовуха	vd̪ɐˈvuxʲɪ
веб-мастер	vɛpməsʲtʲɪˈra
вегетарианец	vʲɪgʲɪtɐˈrjænt͡sɨvʲɪgʲɪtərʲɪˈant͡sɨ
вегетарианство	vʲɪɡʲɪt̪ərʲɪˈan̪s̪t̪və
ведерница	vʲɪˈdʲernʲɪt͡sɨ
ведро	vʲɪˈdro̞
ведёрко	vʲɪˈd̪ʲɵrkʲɪ
ведёрышко	vʲɪˈdʲɵrɨʂkə
веер	vʲɪiˈra
вездеходка	vʲɪzʲdʲɪˈxot̪kə
везун	vʲɪˈz̪un̪
век	vʲek
великолепие	vʲɪlʲɪkɐˈlʲepʲɪjə
великость	vʲɪˈlʲikəsʲtʲɪ
велогонщик	vʲɪɫɐˈgonʲɕɪkʲɪ
велопарк	vʲɪɫɐˈpark
велосипедист	vʲɪɫəsʲɪpʲɪˈdʲist
вельвет	vʲɪˈlʲvʲetɨ
вена	ˈvʲenɨ
венерик	vʲɪˈnʲerʲɪk
венеролог	vʲɪnʲɪˈroɫəgʲɪ
веник	ˈvʲenʲɪkʲɪ
венчик	ˈvʲɛntɕɪkɪ
вера	ˈvʲerə
вербатим	vʲɪrˈbatʲɪm
верблюд	vʲɪrˈblʲʉdɨ
вервь	ˈvʲerfʲ
верес	ˈvʲerʲɪs
веретено	vʲɪrʲɪtʲɪˈno
верняк	vʲɪrˈnʲɪˈkʲi
вероотступник	ˌvʲerəɐtˈstupnʲɪk
вертеп	vʲrˈtʲepɨ
вертоград	vʲɪrtɐˈgradɨ
вертун	vʲɪrt̪ʊˈn̪ɨ
вертуха	vʲɪrˈtuxʲɪ
верхотура	vʲɪrxɐˈturɨ
вершительница	vʲɪrˈʂɨtʲɪlʲnʲɪt͡sə
вершник	ˈvʲerʂnʲɪkʲɪ
вес	vʲes
веселинка	vʲɪsʲɪˈlʲin̪kʲɪ
весло	ˈvʲɵsɫə
весна	ˈvʲɵsnɨ
вест	ˈvʲestɨ
вестка	ˈvʲes̪t̪kʲɪ
весы	vʲɪˈsɨ
весь	vʲesʲ
ветвление	vʲɪt̻vˈlʲenʲɪjə
ветер	ˈvʲetrɨvʲɪtˈra
ветеранка	vʲɪtʲɪˈran̪kə
ветеринар	vʲɪtʲɪrʲɪˈnarɨ
ветеринария	vʲɪtʲɪrʲɪnɐˈrijɪ
ветерочек	vʲɪtʲɪˈrot͡ɕkʲɪ
ветка	ˈvʲetkʲɪ
ветр	vʲet̪r
ветреница	ˈvʲet̪rʲɪnʲɪt͡sə
ветрище	vʲɪt̪ˈrʲiɕːə
ветрюга	vʲɪˈt̪rʲʉ̞ɡə
ветряга	vʲɪˈt̪rʲaɡə
ветрянка	vʲɪtˈrʲænkə
ветчина	vʲɪˈʨːinɨ
вехотка	vʲɪˈxot̪kə
вечер	vʲɪt͡ɕɪˈra
вечерня	vʲɪˈtɕɛɾnʲæ
вечерочек	vʲɪt͡ɕɪˈro̞t͡ɕɪk
вешалка	ˈvʲeʂəɫ̪kʲɪ
вещание	vʲɪˈɕːænʲɪjə
вещество	vʲɪɕːɪˈstvo̞
вещун	vʲɪˈɕːun̪
взаимодоверие	vzəjmədɐˈvʲerʲɪjə
взаимозачёт	vzəɪməzɐˈʨɵt
взаимопонимание	vzəɪməpənʲɪˈmanʲɪjə
взаимосвязь	vzəimɐˈs⁽ʲ⁾vʲæsʲ
взбрык	vzbrɨk
взбухание	vz̪bʊˈxänʲɪjɛ
взварец	ˈvz̪vart͡sɨ
взвоз	vz̪vos̪
взгляд	ˈvzɡlʲædɨ
взгорбок	ˈvz̪ɡorpkʲɪ
взгорочек	ˈvz̪ɡorət͡ɕɪk
взгорье	ˈvz̪gorʲjə
вздор	vzdo̞r
вздорщик	ˈvz̪d̪orʲɕːɪkʲɪ
вздёржка	ˈvzʲdʲɵrʂkə
взлиза	ˈvzlʲizə
взмах	ˈvzmɑxʲɪ
взор	ˈvzorɨ
взрезывание	ˈvz̪rʲez̪ɨvənʲɪɪ̯ə
взрывчатка	vzrɨ̞fˈʨatkʲɪ
взрыд	vzrɨt
взъём	ˈvzjɵmɨ
вибрация	vʲɪˈbrat͡sɨɪ̯ə
вибрион	vʲɪbrʲɪˈo̞n̪
вибровязкость	vʲɪbrɐˈvʲæskəsʲtʲɪ
вигвам	vʲɪɡˈvamɨ
вид	vʲidɨ
видеоплёнка	vʲɪdʲɪɐˈplʲɵnkʲɪ
виджей	vʲɪˈdʐɛɪ̯
византолог	vʲɪzɐnˈtoləɡʲɪ
визитка	vʲɪˈzʲitkʲɪ
викарий	viˈkarʲij
вики	ˈvʲikʲɪ
википидор	ˌvʲikʲɪˈpʲid̪ər
виктрола	vʲɪˈktro̞lɨ̞
вилайет	vʲɪɫɐˈjɛt̪
вилка	ˈvʲiɫkʲɪ
виловый	ˈvʲiɫəvɨj
вино	ˈvʲinə
виноградарь	vʲɪnɐɡˈradərʲ
виноградина	vʲɪnɐˈgradʲɪnɨ
виноградник	vʲɪnɐˈgrɑd̻ʲnʲɪk
виноторговец	vʲɪnətɐrˈɡovʲɪt͡s
вирд	vʲirt̪
вирусология	vʲɪrʊsɐˈɫogʲɪjə
виселица	ˈvʲisʲɪlʲɪtsɨ
висок	vʲɪsˈkʲi
вист	ˈvʲistɨvʲɪsˈtɨ
висячий	vʲɪˈsʲæt͡ɕɪɪ
витраж	vʲɪtrɐˈʐɨ
витрина	vʲɪˈtrʲinə
витушка	vʲɪˈt̪uʂkə
витьё	vʲɪˈtʲjɵ
вихляй	vʲɪxˈɫ̪ʲæɪ̯j
вихорчик	vʲɪˈxort͡ɕɪkʲɪ
вишенка	ˈvʲiʂɨnkʲɪ
вишнуит	vʲɪʂnʊˈitɨ
вишнёвочка	vʲɪʂˈnʲɵvət͡ɕkʲɪ
вкладыш	ˈfkladɨɕ
вковка	ˈfkofkʲɪ
вкрапление	fkrɐpˈlʲenʲɪjə
влагалище	vɫɐˈɡalʲɪɕːə
владимирка	vɫɐˈdʲimʲɪrkə
владычество	vɫɐˈdɨtɕɪstvə
влажность	ˈvɫɑʐnəsʲtʲɪ
влечение	vlʲɪˈt͡ɕenʲɪjə
влог	ˈvɫoɡʲɪ
внедорожник	vnʲɪd̪ɐˈroʐnʲɪk
внимательность	vnʲɪˈmatʲɪlʲnəsʲtʲ
внутренности	ˈvnutʲrʲɪnnəstʲɪ
внутренность	ˈvnutrʲɪnəsʲtʲɪ
внучка	ˈvnutɕkə
вовлечение	vəvlʲɪˈt͡ɕenʲɪjə
водник	ˈvod⁽ʲ⁾nʲɪk
водовозный	vədɐˈvoznɨj
водолаз	vədɐˈɫazɨ
водолей	vədɐˈlʲei
водолюб	vədɐˈlʲʉ̞p
водомёт	vədɐˈmʲɵtɨ
водоотвод	vədɐːtˈvot
водопад	vədɐˈpat
водопой	vədɐˈpoɪ
водополица	vədɐˈpolʲɪt͡sɨ
водопровод	vədəprɐˈvot
водораздел	vədərɐzʲˈdʲel
водоросль	ˈvodɐrɐslʲɪ
водосбор	vədɐˈzborɨ
водосток	vədɐˈstokʲɪ
водохранилище	vədəxrɐˈnʲilʲɪɕːə
воеводство	vəjɪˈvotstvə
военачальник	vəɪnɐˈt͡ɕælʲnʲɪk
возбудительница	vəzbʊˈdʲitʲɪlʲnʲɪt͡sɨ
возвещатель	vəzvʲɪˈɕːatʲɪlʲɪ
возвращенец	vəzvrɐˈɕːent͡sɨ
возвращение	vəz̪vrɐˈɕːenʲɪɪ̯ə
возвращенка	vəzvrɐˈɕːenkə
возгонка	vɐzˈgonkʲɪ
воздушник	vɐˈzduʂnʲɪkʲɪ
воззвание	vɐˈzːvanʲɪjə
возишко	vɐˈzʲiʂkʲɪ
возложение	vəzlʌˈʐenʲɪjɪ
возмутительница	vəzmʊˈtʲitʲɪlʲnʲɪt͡sə
возобновитель	vəzəbnɐˈvʲitʲɪlʲ
возобновительница	vəzəbnɐˈvʲitʲɪlʲnʲɪt͡sə
возражательница	vəzrɐˈʐatʲɪlʲnʲɪt͡sɨ
возраст	ˈvo̞z̪rəs̪t̪ɨ
возчик	ˈvoɕːɪkʲɪ
воитель	vʌˈitʲilʲi
войлочек	ˈvoɪ̯lət͡ɕɪk
война	vɐjˈna
вокалистка	vəkɐˈlʲistkə
вокзальчик	vɐɡˈzalʲt͡ɕɪkʲɪ
волапюк	vɐɫ̪ɐˈpʲʉ̞kʲɪ
волдырик	vɐlˈdɨrʲɪk
волдырчик	vɐlˈdɨrt͡ɕɪkʲɪ
волдырь	vəldɨˈrʲi
волдырёк	vəldɨˈrʲɵk
волк	voɫk
волкобой	vəlkɐˈboɪ̯
волколак	vəɫkɐˈɫak
волна	vɐɫˈna
волнушечка	vɐlˈnuʂɨt͡ɕkə
волнянка	vɐlˈnʲankə
волокита	vəɫɐˈkʲitə
волокнит	vəlɐkˈnʲit
волос	ˈvo̞ɫ̪əs̪ɨ
волосастость	vəlɐˈsastəsʲtʲɪ
волосня	vəlɐˈsʲnʲi
волосочек	vəlɐˈsot͡ɕɪk
волоёб	vəɫɐˈjɵp
волчиха	vɐlˈt͡ɕixʲɪ
волчица	vɐɫˈʨitsɨ
волчок	vɐɫˈʨɵk
волчонок	vɐlˈt͡ɕatə
волынщица	vɐˈlɨnʲɕːɪt͡sə
вольнодумка	vəlʲnɐˈdumkʲɪ
вольтметр	vɐlʲtˈmʲetrɨ
вольфрамовый	vɐɫʲˈframəvɨjə
волюм	vɐˈlʲʉ̞mɨ
воля	ˈvolʲə
вонючесть	prɨˈguʨɪsʲtʲɪ
воображуля	vəɐbrɐˈʐulʲə
вооруженец	vəɐrʊˈʐɛnt͡sɨ
воплотительница	vəplɐˈtʲitʲɪlʲnʲɪt͡sə
вопросец	vɐˈprosʲɪt͡s
вопросительность	vəprɐˈsʲitʲɪlʲnəsʲtʲɪ
ворвань	ˈvorvənʲɪ
воробей	vərɐˈbʲji
воробейчик	vərɐˈbʲeɪ̯t͡ɕɪkʲɪ
вороватость	vərɐˈvatəsʲtʲ
ворожей	vərʌˈʒɛj
ворожка	vɐˈroʂkə
ворона	vɐˈronə
воротник	vərətnʲɪˈkʲi
воскобой	vəskɐˈboɪ̯
восколей	vəskɐˈlʲeɪ̯
воскресенье	vəskrʲɪˈsʲenʲjə
воскресительница	vəskrʲɪˈsʲitʲɪlʲnʲɪt͡sɨ
воспламенитель	vəspləmʲɪˈnʲitʲɪlʲɪ
воспроизведение	vəsprəɪzvʲɪˈdʲenʲɪjə
восхваление	vəsxvɐˈlʲenʲɪjə
восхождение	vəsχɐʐˈdʲenɪjə
восьмидераст	vɐsʲmʲɪdʲɪˈras̪t̪
восьмидесятник	vəsʲmʲɪdʲɪˈsʲætʲnʲɪkʲɪ
воцерковление	vətsɛrkɐvˈlʲenʲɪjə
вошь	fʂɨ
вояж	vɐˈjæʂ
вояка	vʌˈjakə
вписка	ˈfpʲiskə
враг	vrak
враль	vrɐˈlʲi
вратарь	vrɐˈtarʲ
врач	vraʨ
врачиха	vrɐˈʨiχʲɪ
вред	vrʲet
вредина	ˈvrʲedʲɪn̪ɨ
вредитель	vrʲɪˈdʲitʲɪlʲ
врезка	ˈvrʲeskʲɪ
вселение	fsʲɪˈlʲenʲɪɪ̯ə
всесторонний	vsʲɪstɐˈronʲɪj
всполох	fspʌˈloxˈfspoləx
вторник	ˈftornʲɪk
второстепенность	vtoɾəstʲɪˈpʲenːəstʲ
вторяк	ftərʲɪˈkʲi
втуз	ˈftuzɨ
втулка	ˈftuɫkʲɪ
вуаль	vʊˈalʲ
вулканизатор	vʊɫkənʲɪzɑtər
вулканолог	vʊɫkɐˈnoɫəgʲɪ
вульва	ˈvulʲvɨ
выверт	ˈvɨvʲɪrt
выводок	ˈvɨvətkʲɪ
выделка	ˈvɨdʲɪɫkʲɪ
выдра	ˈvɨd̪rə
вызов	ˈvɨzəf
выменять	ˈvɨmʲɪnʲatʲ
вымирание	vɨmʲɪˈranʲɪjə
вымя	ˈvɨmʲə
вынос	ˈvɨnəsɨ
выноска	ˈvɨnəskʲɪ
выпивоха	vɨpʲɪˈvoxʲɪ
выправка	ˈvɨprəfkə
выпряжка	ˈvɨprʲɪʂkʲɪ
выражение	vɨ̞rɐˈʐɛnʲɪjə
вырезка	ˈvɨrʲɪskə
высер	ˈvɨsʲɪrɨ
выскочка	ˈvɨskətɕkə
высокомерие	vɨsəkɐˈmʲerʲɪjə
высокомерный	vɨsəkɐˈmʲernɨjə
высотка	vɨˈsotkʲɪ
высочество	vɨsˈotʃʲestva
вытекание	vɨtʲɪˈkanʲɪjə
вытяжка	ˈvɨtʲɪʂkʲɪ
выходка	ˈvɨxətkə
выхухоль	ˈvɨxʊxəlʲ
вычитание	vɨʨɪˈtɑnʲɪjə
вьюн	vʲjʉn
вяз	vʲas
вялость	ˈvʲæɫəsʲtʲ
вёдрышко	ˈvʲɵd̪rɨʂkə
гаваец	gɐˈvaɪt͡s
гавайка	gɐˈvaɪ̯kə
гавань	ˈgavənʲ
гага	ˈgagə
гагат	gɐˈgatɨ
гадательность	ɡɐˈd̪ätʲɪlʲn̪əsʲtʲ
гадина	ˈgɑdʲɪnɨ
гадюка	gɐˈdʲʉkə
гаер	ˈgajɪr
гаечка	ˈɡäɪt͡ɕkə
газетчица	ɡɐˈzʲet͡ɕɪt͡sə
гай	gaj
гайка	ˈgajkə
гайтан	ɡɐjˈtan
галерист	gəlʲɪˈrʲis̪t̪ɨ
галеристка	gəlʲɪˈrʲis̪t̪kə
галета	gɐˈletɨ
галиматья	gəlʲɪmɐˈtʲjæ
галлий	ˈgalʲɪɪ
галлюциноген	gəlʲʉt͡sɨnɐˈgʲenɨ
галоген	gəɫɐˈgʲenɨ
галун	gəɫʊˈnɨ
галька	ˈgalʲkʲɪ
гамильтониан	gəmʲɪlʲtənʲɪˈan
ганаш	ɡən̪əˈʂɨ
гандон	ɡɐn̪ˈd̪o̞n̪ɨ
гандончик	ɡɐn̪ˈd̪o̞n̪t͡ɕɪkʲɪ
гардероб	gərdʲɪˈrop
гарем	gɐˈrʲemɨ
гармоника	gɐrˈmonʲɪkʲɪ
гармошка	ɡɐrˈmoʂkʲɪ
гарпия	ˈɡarpʲɪjə
гарпун	gərpʊˈnɨ
гарт	gartɨ
гастроном	gəstrɐˈnomɨ
гать	ˈɡɑtʲɪ
гауптвахта	gəʊptˈvaxtɨ
гвардеец	ɡvaɾˈdʲɛjtsɨ
гвоздика	gvɐzʲˈdʲikə
гевея	gʲɪˈvʲeɪ
гегельянство	gʲɪgʲɪlʲˈjanstvə
гегемон	gʲɪgʲɪˈmonɨ
гегемония	gʲɪgʲɪˈmonʲɪjə
гедонизм	gʲɪdɐˈnʲizmɨ
гедонист	gʲɪdɐˈnʲist
геенна	gʲɪˈjenːə
гей	ɡʲej
гейропа	ɡʲeɪ̯ˈro̞pɨ
гекзаметр	gʲɪgˈzɑmʲɪtər
геккон	ɡʲɪˈkːo̞n̪
гематома	gʲɪmɐˈtomə
гематрия	gʲɪˈmatrʲɪː
геморрой	gʲɪmɐˈrːoɪ
генеалогия	gʲɪnʲɪɐˈɫogʲɪjə
генерал-лейтенант	gʲɪnʲɪˌrɑɫɫʲɪtʲɪˈnɑnt
генерал-фельдмаршал	gʲɪnʲɪˌrɑɫfʲɪlʲdˈmɑrʂəɫ
генералитет	gʲɪnʲɪrəlʲɪˈtʲet
генотип	gʲɪnɐˈtʲipɨ
геноцид	gʲɪnɐˈt͡sɨt
геоглиф	gjəˈoglʲɪf
география	gʲɪɐˈgrafʲɪjə
геодезия	gʲɪɐˈdɛzʲɪjə
георгин	gʲɪɐrˈgʲin
геральдист	gʲɪrɐlʲˈdʲis̪t̪
геридон	ɡʲɪrʲɪˈd̪on̪ɨ
гермошлем	gʲɪrmɐˈʂlʲem
герой	gʲɪˈroɪ
геронтология	gʲɪrən̻tɐˈɫogʲɪː
герр	ˈɡʲerɨ
герундий	gʲɪˈrunʲdʲɪj
герцог	ˈgʲertsəgʲɪ
гетерогенность	gʲɪtərɐˈgʲenːəsʲtʲ
гетерозис	ɡʲɪt̪ɛˈrozʲɪs̪
гжель	ˈɡʐɛlʲɪ
гиацинт	gʲɪɐˈtsɨntɨ
гибель	ˈɡʲibʲɪlʲ
гидроаэромеханика	gʲɪdrəəɪrədʲɪˈnaʲɪkə
гидрометеоролог	ˌgʲɪdrəmʲɪtʲɪɐˈroləgʲɪ
гидрометр	gʲɪdˈromʲɪtr
гидромотор	gʲɪdrəmɐˈtor
гик	gʲik
гиканье	ˈɡʲikənʲɪ̯ə
гинея	ɡʲɪˈnʲejə
гипероним	gʲɪpʲɪˈronʲɪmɨ
гиперссылка	gʲɪpʲɪrˈsːɨɫkʲɪ
гипертекст	gʲɪpʲɪrˈtʲekst
гиперядро	ɡʲɪpʲɪrˈjadrə
гипноз	gʲɪpˈnos
гипостиль	gʲɪpɐˈsʲtʲilʲɪ
гипосульфит	ˌgʲɪpəslʲˈfʲitɨ
гипотенуза	gʲɪpətʲɪˈnuzə
гипюр	gʲɪˈpʲʉr
гитарист	gʲɪtɐˈrʲist
гитаристка	gʲɪtɐˈrʲistkʲɪ
гифка	ˈɡʲifkə
главарь	gɫəvɐˈrʲi
главенство	gɫɐˈvʲenstvə
гладиолус	gɫədʲɪˈoɫʊs
гладкость	ˈgɫatkəsʲtʲ
гладыш	ˈgɫadɨʂ
гладь	ˈgɫɑdʲɪ
глаз	gɫɐˈza
глазник	ɡɫəzʲnʲɪˈkʲi
гламур	gɫ̪ɐˈmurɨ
гласность	ˈgɫäs̪n̪əsʲtʲ
глашатай	gɫɐˈʂɑtəɪ
глинозём	glʲɪnɐˈzʲɵmɨ
глициния	glʲɪˈtsɨnʲɪjə
глобус	ˈɡlobʊs
глосса	ˈgɫosːə
глоссарий	gɫɐˈsːarʲɪɪ̯
глоссоптерис	ɡlʲɪˈsoptɛrʲɪs
глоттохронология	gɫotːəxrənɐˈɫogʲɪjə
глумление	gɫʊmˈlʲenʲɪjə
глушь	ɡɫ̪uʂ
глюк	ˈglʲʉkʲɪ
гляциология	glʲɪt͡sɨɐˈɫogʲɪjə
гнида	ˈgnʲidə
гниение	gnʲɪˈjenʲɪjə
гном	ˈgnomɨ
гностицизм	gnəsʲtʲɪˈtsɨzm
гну	gnu
гоблин	ˈɡɔblin
гобой	gɐˈboɪ
говнокачка	ɡəvnɐˈkat͡ɕkʲɪ
говнососка	ɡəvnɐˈsoskə
говнюк	ɡɐvˈnʲʉ̞k
говорение	gəvɐˈrʲenʲɪjə
говядина	gɐˈvʲædʲɪnɨ
гоголь	ˈgogəlʲɪ
год	ɡo̞t̪
годоним	ɡɐˈdonʲɪm
гой	ɡoɪ
голландка	gɐˈɫɑntkə
голова	ɡəɫ̪ɐˈvä
головешка	gəɫɐˈvʲeʂkɪ
головокружение	gəɫəvəkrʊˈʐɛnʲɪjə
головорез	gəɫəvɐˈrʲes
голодовка	gəɫɐˈdofkʲɪ
голос	ˈgo̞ɫəs
голубика	ɡəɫʊˈbʲikʲɪ
голубой	ɡəɫ̪ʊˈbo̞ɪ̯
голубок	ɡəluˈbok
голубушка	ɡɐˈɫubʊʂkə
гоминид	ɡəmʲɪˈnʲidɨ
гоминида	ɡəmʲɪˈnʲidə
гомно	ɡɐmˈno
гомозигота	ˌgoməzʲɪˈgotɨ
гомон	ˈgomən
гомосек	gəmɐˈsʲekʲɪ
гомоэротизм	ˌgomɐɪrɐˈtʲiz̪mɨ
гомстед	ˈɡomstɛdɨ
гомункул	gɐˈmun̪kʊɫ̪
гондон	ɡɐn̪ˈd̪on̪ɨ
гончар	gənʨʌˈrɨ
гопник	ˈgopnʲɪk
горб	gɐrˈbɨ
горбатый	gɐrˈbät̪ɨɪ̯
горбач	gɐrˈbaʨ
горбыль	ɡɐrbɨˈlʲi
гордость	ˈgordəsʲtʲ
горелка	gɐˈrʲeɫkə
горемыка	ɡərʲɪˈmɨkʲɪ
горлица	ˈgorlʲɪtsə
горло	ˈgorɫə
горн	ˈgornɨ
горница	ˈɡornʲɪtsɨ
горнолыжник	gərnɐˈɫɨʐnʲɪk
горнолыжница	gərnɐˈɫɨʐnʲɪt͡sə
горностай	ɡərnɐˈstaɪ
горняк	gɐrˈnʲæk
горняцкий	gɐrˈnʲætskʲɪj
город	gərɐˈda
городовой	ɡərəd̪ɐˈvo̞ɪ̯
горох	gɐˈroxʲɪ
горсть	ˈɡo̞rs̪tʲˈɡo̞rsʲtʲɪ
гортензия	gɐrˈtɛnʲzʲɪjə
горчак	gɐrˈt͡ɕak
горчица	ɡɐrˈt͡ɕit͡sə
госдепартамент	ɡəzʲdʲɪpɐrˈtamʲɪntɨ
господарь	gəspɐˈdarʲ
гостиница	ɡɐˈstinit͡sɨ
гость	go̞sʲtʲ
государство	gəsʊˈdarstvə
госуслуга	gəsʊslˈuɡɪ
госязык	ˌɡosjɪzɨˈkʲi
гот	ˈɡotɨ
готовальня	ɡətɐˈvalʲnʲɪ
готовка	gɐˈtofkə
грабиловка	ɡrɐˈbʲiɫəfkə
грабитель	grɐˈbʲitʲɪlʲ
гравий	ˈɡravʲɪɪ
гравитация	grəvʲɪtat͡sɨɪ
град	ˈɡrɑdɨ
градостроение	grədəstrɐˈjenʲɪjə
гражданин	ˈgraʐdənʲɪ
грамм	ˈgrɑm
грамматика	grɐˈmatʲɪkʲɪ
граммема	grɐˈmʲemɨ
грамотей	grəmɐˈtʲeɪ
гранит	grɐˈnʲitɨ
графема	ɡrɐˈfʲemə
графика	ˈgrɑfʲɪkʲɪ
графит	grɐˈfʲitɨ
графон	ɡrɐˈfon̪ɨ
графофобия	grɐfəˈfo̞bɪɪ̯ə
графство	ˈgrafstvə
граффер	ˈgrafʲɪrɨ
граффитчик	grɐˈfʲit͡ɕːɪk
гребень	ˈgrʲebnʲɪ
грев	ɡrʲef
грейпфрут	grɛjpˈfrutɨ
гречиха	grʲɪˈʨixʲɪ
гречка	ˈgrʲeʨkʲɪ
грешник	ˈɡrʲeʂnʲɪk
грешок	ɡrʲɪˈʂok
гриб	grʲip
грива	ˈgrʲivə
гриот	ɡrʲɪˈot̪
грипп	ɡrʲip
грипс	grʲips
гроб	ɡrop
гробик	ˈɡrobʲɪkɪ
гробница	ɡrɐbˈnʲit͡sə
гроздь	grosʲtʲ
громкость	ˈgromkəsʲtʲ
грудник	ɡrʊd̪ˈnʲik
грудь	ˈgrutʲ
грузинка	ɡrʊˈzʲinkʲɪ
грузоотправитель	ɡrʊzəːtprɐˈvʲitʲɪlʲ
грузополучатель	grʊzəpəɫʊˈt͡ɕætʲɪlʲɪˌgruzəpəɫʊˈt͡ɕætʲɪlʲɪ
группа	ˈɡrupːɨ
грушовка	grʊˈɕofkʲɪ
грызло	ˈgrɨzɫə
грызун	grɨ̞ˈzun
грязнуля	grʲɪˈznulʲə
губнушка	ɡʊbˈn̪uʂkʲɪ
гувернёр	gʊvʲɪrˈnʲɵrɨ
гугл	gugl
гуглер	ˈɡuɡlʲɪr
гуж	gʊˈʒɨ
гулаговщина	ɡʊˈɫ̪aɡəfɕːɪn̪ɨ
гулкость	ˈguɫkəsʲtʲɪ
гулька	ˈɡulʲkʲɪ
гуляка	ɡʊˈlʲækʲɪ
гулёна	gʊˈlʲɵnɨ
гумконвой	ˌgʊmkɐn̪ˈvoɪ̯ɪ
гумьер	ɡʊˈmʲjer
гуриец	ɡʊˈrʲijtsɨ
гурийка	ɡʊˈɾʲijkʲɪ
гуркх	ˈɡurkx
гурман	gʊrˈmanᵻ
гурьба	incorrect
гусар	gʊˈsar
гусь	ˈɡusʲɪ
гусятница	gʊsˈʲæt̻nʲɪt͡sə
гуталин	gʊtɐˈlʲin
гуттаперча	gʊtɐˈpʲerʨɪ
гуща	ˈguɕːə
гэбист	ɡɛˈbʲistɨ
гюрза	gʲʉrˈza
гяур	ɡɪˈʉrɨ
даг	d̪ak
дагеротип	dəgʲɪrʌˈtʲip
дагерротип	dəgʲɪrɐˈtʲipɨ̞
дайвер	ˈd̪aɪ̯vʲɪrɨ
дайкон	d̪ɐɪ̯ˈkon̪ɨ
дальнозоркость	dəlʲnɐˈzorkəsʲtʲɪ
дальномер	dəlʲnɐˈmʲer
дальтоник	dɐlʲˈtonʲɪk
дантист	dɐnʲˈtʲist
дарвинизм	darvʲɪˈnʲɪzm
дармоед	dərmɐˈjet
дасия	dɐˈsʲijɪ
датировка	dətʲɪˈrofkə
датчанка	gemy
дацан	dʌˈtsan
дача	ˈdaʨə
даяние	dɐˈjænʲɪjə
двадцатигранник	dvət͡sətʲɪˈgranʲːɪk
дверь	ˈdvʲerʲɪ
двигателист	dvʲɪɡətʲɪˈlʲist
движение	dvʲɪˈʐenʲɪjə
движок	dvʲɪˈʂkʲi
двоеточие	dvəjəˈtoʨɪjə
дворецкий	dvɐˈrʲet͡skʲɪɪ̯
дворницкая	ˈd̪vo̞rnʲɪt͡skəɪ̯ə
двуколка	dvʊˈko̞lkə
дебет	ˈdʲebʲɪt
дебилизм	dʲɪbʲɪˈlʲizm
дебри	ˈdʲebrʲɪ
дебуккализация	dʲɪbʊkːəlʲɪˈzat͡sɨjɪ
дебурбер	dɛbʊrˈbʲerɨ
девайс	dʲɪˈvaɪ̯s̪
девелопер	dʲɪˈvʲeɫəpʲɪr
деверь	dʲɪvʲɪˈrʲja
девушка	ˈdʲevʊʂkə
девясил	dʲɪvʲɪˈsʲiɫ
девятины	dʲɪvʲɪˈtʲinɨ
дед	ˈdʲet
деепричастие	dʲɪːprʲɪˈʨasʲtʲɪjə
дежа	dʲɪˈʐa
деза	ˈd̪ɛz̪ɨ
дезавуирование	dʲɪzəvʉˈirəvənʲɪjə
дезертир	dʲɪzʲɪrˈtʲir
деисус	ˈdɛisʊsɨ
декабрист	dʲɪkɐˈbrʲistɨ
декабрь	dʲɪˈkabrʲ
декурион	dɛkʊrʲɪˈon
делец	dʲɪlʲˈtsɨ
деликатность	dʲɪlʲɪˈkatnəsʲtʲ
делимое	dʲɪˈlʲiməjə
делинквентность	dʲɪlʲɪnkˈvʲentnəsʲtʲɪ
делис	dʲɪˈlʲɪs
делитель	dɪˈlʲitʲɪlʲ
дело	dʲɪˈɫa
делопроизводитель	ˌdʲeɫ̪əprəɪz̪vɐˈdʲitʲɪlʲɪ
дельта	ˈdɛlʲtə
деляга	dʲɪˈlʲägɪ
демагог	dʲɪmɐˈɡok
демагогия	dʲɪmɐˈgogʲɪjə
демимонд	dɛmʲɪˈmondɨ
демиург	dʲɪmʲɪˈurgʲɪ
демон	ˈdʲemən
демонесса	dʲɪmɐˈn̪ɛs̪ːɨ
демонстрация	dʲɪmɐn̪ˈs̪t̪rat͡sɨɪ̯ə
демшиза	dʲɪmˈʂɨzɨ
денатурат	dʲɪnətʊˈratɨdɛnətʊˈratɨ
дендрит	dʲɪnˈdrʲit
дензнак	dʲɪn̪ˈz̪n̪äkʲɪ
день	dnʲi
денёк	dʲɪˈnʲɵk
депрессняк	dʲɪprʲɪsʲnʲɪˈkʲi
депривация	dʲɪprʲɪˈvät͡sɪɪ̯ɪ
дерево	ˈdʲerʲɪvə
деревце	ˈdʲerʲɪft͡sə
деревцо	dʲɪrʲɪfˈt͡so
деревянный	dʲɪrʲɪˈvʲænːɨj
держава	dʲɪrˈʐavɨ
дерзание	d̪ʲɪrˈz̪an̪ʲɪjə
дерзец	dʲɪrˈzʲet͡s
дериватив	dʲɪrʲɪvɐˈtʲif
десна	ˈdʲɵsnɨ
десница	dʲɪsʲˈnʲit͡sɨ
деспотия	dʲɪspɐˈtʲiː
дети	dʲɪˈtʲæ
детоубийство	dʲɪtəʊˈbʲijstvə
детоубийца	dʲɪtəʊˈbʲijtsə
дефектовка	dʲɪfʲɪˈkt̪ofkʲɪ
дефектоскопия	dʲɪfɛktəskɐˈpʲijə
дефолт	dɛˈfoltɨ
деятельность	ˈdʲejɪtʲɪlʲnəsʲtʲ
джамбори	ˈd͡ʑambərʲɪ
джедай	dʐɪˈdaj
джелоба	d̪ʐɨˈɫobə
джем	ɖ͡ʐɛm
джигит	dʐɨˈɡʲitɨ
джигитовка	dʐɨɡʲɪˈtofkʲɪ
джин	dʐɨn
джинса	dʐɨnˈsa
джинсики	ˈd͡ʑɨn̪sʲɪkʲɪ
дзельква	ˈd͡zʲelʲkvə
дзета	ˈdzɛtə
диагональ	dʲɪəgɐˈnalʲ
диалектика	dʲɪɐˈlʲektʲɪkə
диализ	dʲɪˈalʲɪz̪ɨ
диапедез	dʲɪɐpʲɪˈdɛzɨ
диван	dʲɪˈvän̪ɨ
дивергенция	dʲɪvʲɪrˈgʲentsɨɪ
дивертисмент	dʲɪvʲɪrtʲɪs̪ˈmʲen̪t̪ɨ
дивиденд	dʲɪvʲɪˈdʲent
диво	ˈdʲivə
дигисет	dʲɪɡʲɪˈsɛt
дидактика	dʲɪˈdaktʲɪkʲɪ
дижестив	dʲɪʐɛsʲtʲɪf
дизамбиг	dʲɪˈz̪ambʲɪɡʲɪ
диктатор	dʲɪkˈtatər
дилетант	dʲɪlʲɪˈtɑntɨ
диминутив	dʲɪmʲɪnʊˈtʲivɨ
динамит	dʲɪnɐˈmʲit
династия	dʲɪˈnasʲtʲɪjə
динозавр	dʲɪnɐˈzavr
диорама	dʲɪɐˈramɨ
директива	dʲɪrʲɪkˈtʲivɨ
директор	dʲɪˈrʲektər
дирижабль	dʲɪrɪˈʒablʲ
дирхам	dʲɪrˈxamɨ
дирхем	dʲɪrˈxʲemɨ
дискант	ˈdʲis̪kən̪t̪ɨdʲɪs̪ˈkan̪t̪ɨ
дискаунт	dʲɪˈskaunt
дислокация	dʲɪsɫɐˈkatsɨɪ
дистиллятор	dʲɪsʲtʲɪˈlʲætər
дистилляция	dʲɪsʲtʲɪˈlʲæt͡sɨjə
дисфемизм	dʲɪs̪fʲɪˈmʲiz̪m
дифирамб	dʲɪfʲɪˈrambɨ
дифтонг	dʲɪˈftonk
дифф	dʲif
диффамация	dʲɪfːɐˈmat͡sɨjə
дичь	dʲit͡ɕ
до-бемоль	dɔbʲɪmˈolʲɪ
до-диез	dɔdiˈɛs
доба	ˈdobɨ
добро	dɐˈbro̞
добросовестность	dəbrɐˈsovʲɪstnəsʲtʲ
доброхот	dəbrɐˈxo̞t
добряк	dəbrʲɪˈkʲi
доверчивость	d̪ɐˈvʲert͡ɕɪvəsʲtʲ
доводчик	dɐˈvoʨːɪkʲɪ
дог	dok
договор	dəɡɐˈvo̞r
додик	ˈd̪odʲɪkʲɪ
доение	d̪ɐˈɪ̯enʲɪɪ̯ə
дождевик	dəʐdʲɪvʲɪˈkʲi
дождь	do̞ʂtʲ
дозиметр	dɐˈzʲimʲɪtər
дозор	dɐˈzor
доильщица	dɐˈilʲɕːɪt͡sɨ
дойка	ˈdojkə
дока	ˈdokʲɪ
доклад	dəˈkɫat
докудрама	ˌd̪okʊˈd̪ramɨ
долбоебизм	d̪əɫ̪bəɪ̯jɪˈbʲiz̪m
долбоёб	d̪əɫ̪bɐˈɪ̯jo̞bɨ
долбёжка	d̪ɐɫ̪ˈbʲɵʂkʲɪ
долг	dɐɫ̪ˈgʲi
долина	dɐˈlʲinə
доломит	dəlɐˈmʲit
долото	dɐˈɫotə
дольмен	dɐlʲˈmʲen
долёвка	dɐˈlʲɵfkʲɪ
дом	ˈdom
доминанта	dəmʲɪˈnantə
домкрат	dɐmˈkratɨ
домна	ˈdo̞mnə
домовой	dəmɐˈvoj
домочадец	dəmɐˈʨædʲɪts
доносчик	dɐˈnoɕːɪkʲɪ
дорога	dɐˈro̞gə
дородство	dəˈrotstvə
доска	d̪ɐs̪ˈka
доспех	dɐˈsʲpʲexʲɪ
достоинство	dɐˈstoɪnstvə
доха	ˈdo̞xʲɪ
дояр	dɐˈjar
драгдилер	drɐkˈdʲilʲɪr
драгун	drɐˈɡunɨ
драматургесса	d̪rɐmɐt̪ʊrˈɡʲes̪ːə
драммер	ˈdramʲɪrɨ
драник	ˈdranʲɪk
драница	d̪rɐˈnʲit͡sə
драпри	drɐˈprʲi
древко	ˈdrʲefkə
дрек	ˈdrɛkʲɪ
дресс-код	d̪rɛˈs̪kod̪ɨ
дрил	ˈdrʲilɨ
дробина	drɐˈbʲinɨ
дробь	ˈdrobʲɪ
дрога	ˈdroɡʲɪ
дрофа	drɐˈfa
другой	drʊˈgo̞j
дружба	ˈdruʐbɨ̞
друид	druˈidɪ
дрызготня	drɨzgɐt̻ˈnʲi
дрын	ˈdrɨnɨ
дрянцо	d̪rʲɪn̪ˈt͡sä
дуб	dʊˈbɨ
дубачка	dʊˈbat͡ɕkə
дубина	dʊˈbʲinə
дубляж	dʊbˈlʲæʂ
дублёр	dʊˈblʲɵrɨ
дубовка	dʊˈbofkə
дубок	dʊpˈkʲi
дубочек	dʊˈbot͡ɕkʲɪ
дубрава	dʊbˈravə
дукат	dʊˈkatɨ
дуло	ˈduɫɐ
дуля	ˈdulʲə
дума	ˈdumə
дундук	dʊnˈduk
дуплекс	ˈduplʲɪks
дурак	duˈrak
дурень	ˈdurʲɪnʲ
дуриан	dʊrʲɪˈanɨ
дурь	ˈdurʲɪ
дурёха	dʊˈɾʲɵxʲɪ
дух	ˈduxʲɪ
духовка	duˈxovkɪ
душа	dʊˈʂa
душевнобольной	dʊʂɛvn̪əbɐlʲˈn̪o̞ɪ̯
душегубка	dʊʂɨˈgupkə
душенька	ˈduʂɨnʲkə
душица	dʊˈʂɨ̟tsɨ̞
душка	ˈduʂkʲɪ
душман	dʊˈʂman
душок	d̪ʊʂˈkʲi
дуэлянт	dʊɪˈlʲænt
дыба	ˈdɨbə
дым	d̪ɨm
дынька	ˈdɨnʲkɑ
дырокол	dɨrɐˈkoɫɨ
дыхло	ˈdɨhɫə
дышло	ˈdɨʂɫə
дьякон	ˈdʲækənɨ
дюна	ˈdʲʉnɨ
дюралюминий	dʲʉrəlʲlʲʉˈmʲinʲɪː
дятел	ˈdʲætʲɪɫ
дёрн	ˈdʲɵrnɨ
ебанатик	ɪ̯jɪbɐˈn̪ätʲɪk
ебеня	jɪbʲɪˈnʲæ
еблан	jɪˈbɫ̪än̪
еблец	ɪ̯jɪˈblʲet͡s
ебло	ˈjo̞bɫ̪ə
ебля	ˈjɛblʲɪ
ебота	ˈˈɪˈbo̞t̪ɨˈˈ
евгеника	jɪvˈɡʲenʲɪkʲɪ
евнух	ˈjevnʊx
евроинтеграция	ˌjevrəɨn̪tɛˈgrat͡sɨɪ
европейка	jɪvrɐˈpʲeɪ̯kʲɪ
европеянин	jɪvrɐˈpʲeɪ̯ənʲɪ
европеянка	jɪvrɐˈpʲeɪ̯ɪn̪kə
евхаристия	jɪfxɐˈrʲisʲtʲɪjɪ
егэшник	jɪˈɡɛʂnʲɪk
егэшница	jɪˈɡɛʂnʲɪt͡sə
единение	jɪdʲɪˈnʲenʲjə
единомышленница	jɪdʲɪnɐˈmɨʂlʲɪnʲːɪtsə
единообразие	jɪdʲɪnəɐbˈrɑzʲɪjə
единорог	jɪdʲɪnɐˈroɡʲɪ
едок	jɪˈdok
ежевичник	jɪʐɨˈvʲit͡ɕnʲɪk
ектенья	ɛktʲɪnʲˈi
ель	ˈjelʲɪ
енот	jɪˈnot
епископ	jɪˈpʲiskəpɨ
епитимия	jɪpʲɪtʲɪˈmʲjijɪpʲɪtʲɪmʲɪˈi
ер	ˈjerɨjɪˈrɨ
ересиарх	jɪrʲɪsʲɪˈarxʲɪ
есаул	jɪsɐˈuɫɨ
естественность	jɪsʲˈtʲestvʲɪnːəsʲtʲɪjɪsʲˈtʲesʲtʲvʲɪnːəsʲtʲɪ
ефрейтор	ɪfˈrʲejrərɨ
ехидна	jɪˈxʲid̪n̪ɨ
ехиднаэдр	jɛxʲɪˈd̪n̪äɪd̪rɨ
ехидство	jɪˈxʲitstvə
жабра	ˈʐabrə
жадность	ˈʐadnəsʲtʲɪ
жажда	ˈʐaʐdə
жакет	ʐɨˈkʲet
жало	ˈʐalə
жалость	ˈʐaɫəsʲtʲ
жандарм	ʐɐnˈdärm
жанр	ʐanr
жаргон	ʐɐrˈgon
жаргонизм	ʐərɡɐˈnʲizm
жаркое	ʐɐrˈkʲijə
жарок	ʐɐrˈkʲi
жарт	ʐart
жасмин	ʐəsˈmʲinɨʐɐsˈmʲinɨ
жвачка	ˈʐvät͡ɕkə
жгут	ʐɡut
желе	ʐʲɪ̝ˈɫʲe
железнение	ʐəlʲɪzˈnʲenʲɪjɪ
желобок	ʐəɫɐˈbok
желтизна	ʐɨɫtʲɪzˈna
желчность	ˈʐɛɫ̪t͡ɕn̪əsʲtʲ
жемчуг	ʐɛmt͡ɕʉˈɡä
жемчужница	ʐɨmˈʨuʐnʲɪt͡sə
жена	ʐɪ̈ˈna
жених	ʐɪˈnʲix
женоубийство	ʐenəʊˈbʲijstvə
женоубийца	ʐenəʊˈbʲijtsɨ
женофоб	ʐɪ̈n̪ɐˈfobɨ
жердяй	ʐɨrˈd̪ʲæɪ̯j
жеребец	ʐɨrʲɪpˈt͡sɨ
жерех	ˈʐɛrʲɪxʲɪ
жерминаль	ʐɨrmʲɪˈn̪aɫ̪ʲ
жертва	ˈʐɛɾtvə
живец	ʐɨˈvʲet͡s
живодёр	ʐɨvɐˈdʲɵr
живодёрка	ʐɨvɐˈdʲɵrkʲɪ
живописец	ʐɨvɐˈpʲistsɨ
живот	ʐɨvɐˈtɨ
жига	ˈʐɨgə
жид	ʐɨˈdɨ
жидкость	ˈʐɨtkəstʲ
жизнь	ˈʐɨ̟zʲnʲɪ
жилет	ʐɨˈlʲet
жир	ʐɨˈrɨ
жираф	ʐɨˈrɑfɨ
жирафа	ʐɨˈrafə
жирдяй	ʐɨrˈd̪ʲæɪ̯j
жириновка	ʐɨrʲɪˈnofkʲɪ
жирондист	ʐɨrɐnʲˈdʲistɨ
жиряк	ʐɨrʲɪˈkʲi
жлоб	ʐɫɐˈbɨ
жмот	ˈʐmo̞tɨ
жмурик	ˈʐmurʲɪk
жмых	ʐmɨx
жокей	ʐɐˈkʲeɪ
жопник	ˈʐo̞pnʲɪk
жопорожец	ʐəpɐˈroʐtsɨ
жребий	ʐrʲebʲɪj
жужжание	ʐʊˈʑːanʲɪjə
жужик	ˈʐuʐɨkʲɪ
журавль	ʐʊrɐˈvlʲi
журнал	ʐʊrˈn̪äɫɨ
журфикс	ʐʊrˈfʲiks̪
жучара	ʐʊˈt͡ɕarə
жёлтый	ˈʐoɫtɨj
жёлудь	ˈʐo̞lʊdʲɪ
жёнушка	ˈʐonʊʂkʲɪ
забава	zɐˈbavə
забегаловка	zəbʲɪˈgaləfkʲɪ
забияка	zəbʲɪˈjækʲɪ
забойка	zɐˈbojkʲɪ
забойщик	zɐˈbojɕːɪkʲɪ
забор	zɐˈborɨ
забористость	zɐˈborʲɪstəstʲ
забота	zɐˈbotə
забывчивость	zɐˈbɨft͡ɕɪvəsʲtʲ
заведение	zəvʲɪˈdʲenʲɪjə
заведенция	z̪əvʲɪˈdʲen̪t͡sɨɪ
завещание	zəvʲɪˈɕːænʲɪjə
завируха	z̪əvʲɪˈruxə
заводила	zəvɐˈdʲilə
заводь	ˈzavədʲɪ
завсегдатай	zəfsʲɪɡˈdatəɪ
завтрак	ˈzaftrək
завязь	ˈzɑvʲɪsʲ
загадка	z̪ɐˈɡät̪kə
загнивание	zəgnʲɪˈvanʲɪjə
загон	zʌˈgo̞n
заграница	zəɡrɐˈnʲit͡sə
задание	z̪ɐˈd̪anʲɪjə
задел	zɐˈdʲelɨ
задира	zʌˈdʲirɨ
задница	ˈzadnʲɪtsə
задор	zɐˈdorɨ
задрот	z̪ɐˈd̪ro̞t̪ɨ
задымление	z̪əd̪ɨmˈlʲenʲɪjə
заедка	zɐˈjɛtkʲɪ
заимствование	zɐˈimstvəvənʲɪjə
зайчонок	zɐjˈt͡ɕatə
заказчик	zɐˈkaɕːɪkʲɪ
заказчица	zɐˈkaɕːɪtsɨ
закон	zɐˈkonɨ
законопослушный	zəkənəpɐˈsɫuʂnɨjə
закоулок	z̪əkɐˈuɫ̪kʲɪ
закрепощённость	zəkrʲɪpɐˈɕːɵnːəsʲtʲ
закругление	zəkrʊˈɡlʲenʲɪjə
закуска	zɐˈkuskə
закусочная	zɐˈkusəʨnəjə
зал	ˈzɑɫɨ
залежь	ˈz̪älʲəʐ
залив	zɐˈlʲif
заливное	zəlʲɪvˈnɨjə
залп	ˈzaɫpɨ
залупа	z̪ɐˈɫ̪upɨ
замах	z̪ɐˈmäxʲɪ
замещение	z̪ɐmʲɪˈɕɕenʲjə
замок	zɐmˈkʲi
замужество	zɐˈmuʐɨstvə
замшелый	zɐˈmʂɛlɨj
заначка	zɐˈnät͡ɕkə
занятие	zɐˈnʲætʲɪjə
запал	zɐˈpalɨ
запань	ˈz̪äpənʲ
запасы	zɐˈpasɨ
запашка	z̪ɐˈpaʂkə
запев	zɐˈpʲevɨ
запевала	zəpʲɪˈvalə
запевалка	zəpʲɪˈvalkʲɪ
записка	zɐˈpʲiskʲɪ
заплата	zɐˈpɫɑtɨ
заплыв	zɐˈpɫɨf
заповедник	zəpɐˈvʲednʲɪk
заполнитель	zəpɐlˈnʲitʲɪlʲ
запор	zɐˈporɨ
заправщик	z̪ɐˈprafɕːɪkʲɪ
запрет	zɐˈprʲetɨ
запрещение	z̪əprʲɪˈɕːenʲɪə
заражение	zərɐˈʐɛnʲɪjə
зародыш	zɐˈrodɨʂɨ
заросль	ˈzarəslʲ
зарплата	zɐrˈplatə
заря	zɐˈrʲæ
заряд	zɐˈrʲædɨ
зарядочка	zɐˈrædət͡ɕkə
засада	zɐˈsadə
засветка	z̪ɐˈs̪vʲet̪kə
заседание	zəsʲɪˈdanʲɪjə
заселение	zəsʲɪˈlʲenʲɪjə
засилье	zɐˈsʲilʲjə
заслонить	zəsɫɐˈnʲitʲ
засоня	zaˈsonʲɪ
застолбить	zəstɐɫˈbʲitʲ
затвор	zɐˈtvorɨ
затишье	zɐˈtʲiʂjə
затон	zɐˈtonɨ
затор	zɐˈtor
затрещина	zɐˈtrʲeɕːɪnə
затупок	zɐˈtupkʲɪ
затылок	zɐˈtɨɫkʲɪ
заумь	ˈz̪aʊmʲɪ
заутреня	zɐˈʉtɾʲɪnʲɪ
захватчик	zɐˈxvaɗ̥t͡ɕːɪk
заход	zʌˈχot
захолустье	zəxɐˈlusʲtʲjə
захоронение	zəxərʌˈnʲenʲɪ̝jə
зачёт	zɐˈt͡ɕɵt
защитник	zɐˈɕːitnʲɪkʲɪ
заява	zɐˈjavɨ
звезда	ˈzvʲo̞zdɨ
звездовик	zvʲɪzdəvʲɪˈkʲi
зверобойка	z̪vʲɪrɐˈbo̞ɪ̯kə
зверь	zvʲerʲ
звон	ˈzvonɨ
звуковик	z̪vʊkɐˈvʲik
звукоизоляция	zvʊkəɪzɐˈlʲætsɨjə
звучность	ˈzvuʨnəsʲtʲɪ
звёздочка	ˈzvʲɵzdətɕkʲɪ
зга	z̪ɡä
здание	ˈzdanʲɪjə
зебра	ˈzʲebrɨ
зевака	zʲɪˈvakʲɪ
зек	zɛk
земля	ˈzʲe̝mlʲɪ
земляк	zʲɪmlʲɪˈki
земляника	zʲɪmlʲɪˈnʲikə
землянин	zʲɪmˈlʲænʲɪ
зенит	zʲɪˈnʲitɨ
зерно	ˈzʲɵrnə
зернь	zʲernʲ
зефир	zʲɪˈfʲir
зигзаг	zʲɪgˈzɑk
зиккурат	zʲɪkʊˈratɨ
зикр	ˈzʲikrɨ
зима	zʲɪˈma
зимовье	zʲɪˈmo̞vʲjə
зимометр	zʲɪˈmomʲɪtr
злак	ˈzɫɑkʲɪ
зло	zɫo̞
злоба	ˈzɫobə
злодеяние	zɫədʲɪˈjænʲɪjə
злоключение	zɫəklʲʊˈʨenʲɪjə
злопыхательство	zɫəpɨˈχatʲɪlʲstvə
злорадство	zɫɐˈratstvə
злословие	zɫɐˈsɫovʲɪjə
злотый	ˈzɫotɨj
злоупотребление	zɫəʊpətrʲɪbˈlʲenʲɪjə
змий	ˈz̪mʲiɪ
знание	ˈznɑnʲɪjə
знать	ˈznɑtʲɪ
знахарка	ˈznäxərkʲɪ
зоб	zop
зов	zof
зодиак	zədʲɪˈak
зодчество	ˈzott͡ɕɪstvə
зодчий	ˈzott͡ɕɪjɪ
зола	ˈzoɫɨ
золовка	zɐˈɫofkə
золотуха	zəɫɐˈtuxʲɪ
зомби	ˈzomʲbʲɪ
зона	ˈzonɨ
зонт	zɐn̪ˈtɨ
зонтик	ˈzonʲtʲɪk
зорб	zorp
зрачок	zrɐʨˈkʲi
зуб	zup
зубило	zʊˈbʲiɫə
зубочистка	zʊbɐˈʨistkə
зубчатка	zʊpˈʨætkə
зулус	zʊˈɫus
зурна	zʊˈrnɨ
зушка	ˈz̪uʂkə
зыбь	z̪ɨpʲ
зэк	zɛkʲɪ
зюйд	zʲʉjt
зять	zʲɪtʲˈjæ
зёма	ˈzʲɵmɨ
иван-чай	ɪˌvanˈt͡ɕaɪ̯
ивняк	ɪvˈnʲæk
иврит	ɪvˈrʲitɨ
иглоукалывание	ɪgɫəʊˈkɑɫɨvənʲɪjə
иго	ˈiɡə
игольник	ɪˈgolʲnʲɪkʲɪ
игра	ˈigrɨ̞
игрушка	ɪgˈruʂkə
идеал	ɪdʲɪˈɑɫɨ
идеализм	idʲɪɐˈlʲiz̪mɨ
идеологема	ɪdʲɪəɫ̪ɐˈgʲemə
идиот	ɪdʲɪˈot
идиотизм	ɪdʲɪɐˈtʲizmɨ
идиотия	ɪdʲɪɐˈtʲijɪ
идиш	ˈidɨʂɨ
иерархия	ɪʲɪˈrarxɪː
иерей	ɪjɪˈrʲej
иероглиф	ɪjəˈroglʲɪfɨjəˈroglʲɪfɨ
иешива	iɪ̯ɪˈʂɨvɨ
изба	ˈiz̪bɨ
избыток	ɪzˈbɨtək
изверг	ˈiz̪vʲɪrɡʲɪ
известняк	ɪzvʲɪsʲnʲɪˈkʲiɪzvʲɪsʲtʲnʲɪˈkʲi
извинение	ɪzvʲɪnʲenʲɪjə
изгиб	ɪzˈgʲibɨ
изгой	ɪzˈgoɪ̯
изделие	ɪzʲˈdʲelʲɪjə
изжога	iˈʐːoɡə
излишек	ɪzˈlʲiʂkʲɪ
излучение	ɪzɫʊˈʨenʲɪjə
изменник	ɪzˈmʲenʲːɪk
изменница	ɪzˈmʲenːɪt͡sɨ
изменщик	ɪzˈmʲenʲɕɪkʲɪ
изморозь	ˈizmərəzʲɪ
изнасилование	ɪznɐˈsʲiləvənʲɪjə
изобилие	ɪzɐˈbʲilʲɪjə
изображение	ɪzəbrɐˈʐenʲɪjə
изобретатель	ɪzəbrʲɪˈtatʲɪlʲ
изобретательность	ɪzəbrʲɪˈtatʲɪlʲnəsʲtʲ
изогипса	ɪzɐˈgʲipsə
изолятор	ɪzɐˈlʲætərɨ
изразец	ɪzrɐsˈtsɨ
израильтянин	ɪzrəɪlʲˈtʲænʲɪ
изумительность	izʊˈmʲitʲɪlʲnəsʲtʲɪ
изумруд	ɪzʊmˈrut
изъян	ɪzˈjanɨ̞
икона	ɪˈkonə
икт	ˈiktɨ
иллюзия	ɪˈlʲːʉzʲɪjə
имбирь	ɪmˈbʲirʲ
имевшийся	ɪmʲefʂɨjsʲə
имение	ɪˈmʲɛnʲɪje
именины	ɪmʲɪˈnʲinɨ
именительный	ˈɪmʲɪnʲitʲɪlʲn̪ɨjɪ̈
имидж	ˈimʲɪt͡ʃ
император	ɪmpʲɪˈratərɨ
империалист	ɪmʲpʲɪrʲɪɐˈlʲistɨ
империя	ɪmʲˈpʲerʲɪjə
имперсонатор	ɪmpʲɪrsɐˈnatərɨ
имущество	ɪˈmuɕːɪstvə
имя	ɪmʲɪˈna
ингибитор	ɪnɡʲɪˈbʲitərɨ
ингумация	ɪnɡʊˈmatsɨɪ
индеец	ɪˈnʲdʲejtsɨ
инди-рок	ˌin̪dʲɪˈrokʲɪ
индивидуум	ɪndʲɪˈvʲidʊmɨ
индий	ˈinʲdʲɪj
индифферентность	ɪnʲdʲɪfʲɪˈrʲentnəsʲtʲɪ
индоариец	ɪndɐɐˈrʲijɪt͡s
индоарий	ɪndɐˈarʲɪɪ
индюк	ɪnˈdʲuk
иней	ˈinʲɪjɪ
инициаль	ɪnʲɪt͡sɨˈalʲɪ
инициатива	ɪnʲɪtsɨɐˈtʲivɨ
инкремент	ɪnkrʲɪˈmentɨ
иннервация	ɪnːərˈvatsɨː
иноверец	ɪnəˈvʲɛrʲtsɨ
инок	ˈin̪əkʲɪ
иносказание	in̪əs̪kɐˈz̪änʲɪɪ̯ə
институт	ɪnsʲtʲɪˈtut
интеллигенция	in̪tʲɪlʲɪˈɡʲen̪t͡sɨɪ̯ə
интерес	ɪnʲtʲɪˈrʲes
интерлиньяж	ɪntɛrlʲɪˈnʲjaʐɨ
интерьер	ɪntərʲˈjɛr
интрига	ɪntˈrʲiɡʲɪ
интуиция	in̪t̪ʊˈɪ̯it͡sɨɪ̯ɪ
инфантерия	ɪnfɐnˈtɛrʲɪjə
инфантильность	ɪnfɐnʲˈtʲilʲnəsʲtʲ
инфинитив	ɪnfʲɪnʲɪˈtʲif
инфляция	ɪnˈflʲæt͡sɨjə
информатизация	ɪnfərmətʲɪˈzat͡sɨjə
информация	ɪnfʌrˈmatsɨ̞i
ион	ɪˈo̞nɨˈjo̞nɨ
ипокрит	ipɐˈkrʲit̪ɨ
ипостась	ɪpɐˈstasʲ
ирга	ɪrˈgä
ирод	ˈirədɨ
ирокез	ɪrɐˈkʲes
искательница	ɪsˈkɑtʲɪlʲnʲɪtsɨ
исключительный	ɪsklʲʉˈʨitʲɪlʲnɨjə
искорка	ˈiskərkə
исповедь	ˈispəvʲɪtʲ
исправление	ɪsprɐvˈlʲenʲɪjə
истерия	ɪsʲtʲɪˈrʲiː
истечение	ɪsʲtʲɪˈt͡ɕenʲɪjə
историк	ɪsˈtorʲɪkʲɪ
история	ɪsˈtorʲɪjə
итальянец	ɪtɐˈlʲjænʲɪt͡s
иттрий	ˈitrʲɪɪ
иудаизм	ɪʊdɐˈizm
иудаика	iuˈd̪aikə
иудаистика	iud̪ɐˈisʲtʲɪkə
иудей	ɪʊdʲɛj
июль	ɪˈjʉlʲɪ
июнь	ɪˈjʉnʲ
йети	ˈjetʲɪ
йидиш	ˈjidʲɪʂ
йога	ˈjɵgə
йотирование	jɐˈtʲirəvənʲɪjə
кабак	kɐbɐˈkʲi
кабан	kəbɐˈn̪ɨ
кабатчик	kɐˈbaʨːɪkʲɪ
кабель	ˈkɑbʲɪlʲ
каблук	kɐbˈɫuk
каботаж	kəbɐˈtɑʂ
каботажник	kəbɐˈtaʐnʲɪk
кабысдох	kəbɨˈz̪d̪o̞x
кавалерист	kəvəlʲɪˈrʲist
кавказец	kɐfˈkast͡sɨ
кавказка	kɐfˈkazkə
кавыка	kɐˈvɨkʲɪ
кавычка	kɐˈvɨt͡ɕkʲɪ
кагебешник	kəɡɨˈbɛʂnʲɪkʲɪ
кагэбэшник	kəɡɨˈbɛʂnʲɪkʲɪ
каданс	kɐˈdans
кадило	kɐˈdʲiɫə
кадмий	ˈkadmʲɪɪ
кадр	ˈkadrɨ
кадык	kɐˈdɨk
казак	kɐˈzak
казан	kɐz̪ɐˈn̪ɨ
казанский	kɐˈzanskʲɪjə
казарка	kʌˈzarkʲɪ
казах	kɐˈzaxʲɪ
казачка	kɐˈzatɕkɪ
казачок	kɐzɐˈtɕo̞k
казино	kəzʲɪˈno
казначей	kɐznɐˈʨeɪ
казнь	ˈkazʲnʲɪ
кайдзю	ˈkaɪ̯d͡zʲʉ
кайнозой	kəjn̪ɐˈzoj
кайт	ˈkaɪ̯tɨ
кайтинг	ˈkaɪ̯tn̻gʲɪ
кайфолом	kəɪ̯fɐˈɫ̪o̞m
какашка	kɐˈkaʂkə
каламбур	kəɫɐmˈbur
каланча	kəlɐnʲˈt͡ɕa
калач	kəɫɐˈt͡ɕi
калека	kɐˈlʲekə
календарь	kəlʲɪnˈdarʲ
календула	kɐˈlʲen̪d̪ʊɫ̪ɨ
калибровка	kəlʲɪbˈrofkə
кало	kaˈlo
калька	ˈkɑlʲkə
кальмар	kɐlʲˈmar
камедь	kɐˈmʲedʲɪ
камень	ˈkamnʲɪ
каминный	ˈkamʲinːɨɪ̯
камка	kɐmˈkä
камнетёс	kəmnʲɪˈtʲɵs̪ɨ
кампания	kɐmˈpanʲɪː
камыш	kəmɨˈʂɨ
канава	kɐˈnavɨ
канал	kɐˈnaɫɨ
канализация	kənəlʲɪˈzɑtsɨɪ
канат	kɐˈnɑt
кандела	kɐnˈdɛlə
кандзи	ˈkandzʲɪ
канитель	kənʲɪˈtʲelʲɪ
канифоль	kənʲɪfo̞lʲɪ
каннибал	kənʲɪˈbaɫ
каннибализм	kənʲːɪbɐˈlʲizm
каноник	kɐˈn̪onʲɪk
каноэ	kɐˈnoə
кантилляция	kən̪tʲɪˈlʲat͡sɨjə
канцероген	kəntsɛrɐˈgʲenɨ
канюк	kənʲʉˈkʲi
канюля	kanʲulʲa
каолин	kɐːˈlʲin
капитан	kəpʲɪˈtan
капитошка	kəpʲɪˈt̪oʂkʲɪ
капитуляция	kəpʲɪtʊˈlʲætsɨjə
капор	ˈkapərɨ
капотаж	kəpɐˈtaʂ
капсула	ˈkapsʊɫə
каптан	kɐpˈt̪an̪ɨ
капуста	kɐˈpustɨ
капюшон	kəpʲɪˈʂon
кара	ˈkarə
карабин	kərɐˈbʲinɨ
караван	kərɐˈvanɨ
каравелла	kərɐˈvɛlːə
каракатица	kərɐˈkatʲitsɨ
караконджул	kərəkəndʒul
каракуля	kɐˈrakʊlʲɪ
карамелька	kərɐˈmʲelʲkʲɪ
карандаш	kərəndɐˈʂɨ
карандашница	kərɐnˈdaʂnʲɪt͡sɨ
караоке	kərɐˈokʲɪ
карат	kɐˈrat
карбованец	kɐrˈbovənt͡sɨ
каре	kɑˈrɛ
кареглазый	kɐɾʲɪˈɡɫazɨj
каркуша	kɐrˈkuʂɨ
карма	ˈkarmɨ
карман	kɐrˈmän̪
карнавал	kərnɐˈvaɫɨ
карниз	kɐrˈnʲis
карта	ˈkartɨ
картотека	kərtɐˈtʲekʲɪ
картофелина	kɐrˈtofʲɪlʲɪnɨ
картоха	kɐrˈtoxʲɪ
карточка	ˈkartəʨkə
карты	ˈkartɨ
картёж	kərtʲɪˈʐɨ
касалетка	kəsɐˈlʲetkə
каска	ˈkaskʲi
касса	ˈkasːɨ
каст	käs̪t̪
каста	ˈkastə
кастаньета	kəstɐˈnʲjetɨ
кастодиан	kəstədʲɪˈan
катана	kɐˈtanɨ
катарсис	ˈkatərsʲɪs
катастройка	kɐt̪ɐˈs̪t̪roɪ̯kʲɪ
катастрофа	kətɐˈstrofə
катафалк	kətɐˈfalk
катахреза	kətɐˈxrʲezɨ
категория	kətʲɪˈgorʲɪjə
катерна	kɐˈtɛrnɨ
католик	kaˈtolʲɪk
катран	ˈkät̪rən̪ɨkɐˈt̪rän̪ɨ
катушка	kɐˈtuʂkə
каузация	kəʊˈzatsɨjə
каучук	kəʊˈtʃukʲi
кафе	kɐˈfɛ
кафель	kɑfʲɪlʲɪ
кафтан	kɐfˈtanɨ
кафф	kaf
кацавейка	kətsɐˈvʲejkə
кацап	kɐˈt͡sap
кач	ˈkat͡ɕɪ
качалка	kɐˈt͡ʃäɫ̪kʲɪ
качели	kɐˈt͡ɕɛlʲɪ
качество	ˈkaʨɪstvə
качок	kɐʨˈkʲi
каша	ˈkɑʂɨ
кашемир	kəʂɨˈmʲir
квадрицепс	kvʌˈdrʲitsɪps
квадрокоптер	kvədrɐˈkoptər
кваканье	kväkənʲə
квалификация	kvəlʲɪfʲɪˈkat͡sɨjɪ
кварк	ˈkvark
квартплата	ˌkvɐrt̪ˈpɫ̪at̪ə
кварц	kvarts
квас	kvɐˈsɨ
квашня	kvɐʂˈnʲa
кветочек	kvʲɪˈtot͡ɕɪk
квикстеп	kvʲɪkˈstɛpɨ
квинта	ˈkvʲintə
кворум	ˈkvorʊm
кегль	kʲeglʲ
келья	ˈkʲelʲjə
кемекс	ˈkʲemʲɪksɨ
кенгуру	kʲɪngʊˈru
кенгурёнок	kʲɪngʊˈrʲɵnək
кенотаф	kʲɪnɐˈtaf
кентавр	kʲɪnˈtavrɨ
керосин	kʲɪrɐˈsʲinɨ
кет	kʲet
кетчуп	ˈkʲet͡ɕʉpɨ
кефир	kʲɪ̝ˈfʲir
кибернетика	kʲɪbʲɪrˈnɛtʲɪkʲɪ
киборгизация	kʲɪbərgʲɪˈzat͡sɨjə
кивер	ˈkʲivʲɪr
киви	ˈkʲivʲɪ
кивок	kʲɪfˈkʲi
кижуч	ˈkʲiʐʊt͡ɕ
кизил	kʲɪˈziɫ
кий	kiˈjɪ
кикер	ˈkʲikʲɪr
кила	kʲɪˈɫa
килт	kʲilt
киль	kʲilʲ
кильватер	kʲɪlʲˈvatɛr
кинематика	kʲɪnʲɪˈmatʲɪkʲɪ
кинжал	kʲɪnˈʐaɫɨ̞
киноварь	ˈkʲinəvərʲ
киноплёнка	kʲɪnɐˈplʲɵnkə
кинофильм	kʲɪnɐˈfʲilʲm
киношка	kʲɪˈn̪oʂkə
киот	kʲɪˈot̪
кипеш	ˈkʲipʲɪʂ
кипрей	kʲɪˈprʲeɪ̯
кираса	kʲɪˈrɑsə
кирасир	kʲɪrɐˈsʲirɨ
киргиз	kʲɪrˈɡʲizɨ
кирдык	kʲɪrˈd̪ɨk
кирха	ˈkʲirxʲɪ
киса	kʲɪˈs̪ä
кислица	ˈkʲislʲɪt͡sɨ
кислота	kʲɪsˈlotɯ
кислотность	kʲɪsˈɫotnəsʲtʲɪ
кит	kʲit
китайка	kʲɪˈtɑjkʲɪ
китобой	kʲɪtɐˈboj
кишка	kʲɪʂˈka
клава	ˈkɫavə
клавиатура	kɫəvʲɪɐˈturɨ
клавиша	ˈkɫɑvʲɪʂɨ
клад	ˈklɑdɨ
клада	ˈkɫadɨ
кладовая	kɫədɐˈvajə
кладовка	kɫɐˈdofkə
кладоискатель	kɫədəɪsˈkatʲɪlʲˌkɫadəɪsˈkatʲɪlʲ
кладоискательство	ˌkɫ̪ɐd̪əɪs̪ˈkätʲɪlʲs̪t̪və
клановость	ˈkɫanəvəsʲtʲɪ
классификатор	kɫəsʲɪfʲɪˈkɑtərɨ
классификация	kɫəsʲːɪfʲɪˈkat͡sɨjɪ
кластер	ˈklasʲtʲɪr
клаузула	ˈkɫ̪aʊz̪ʊɫ̪ə
клевер	ˈklʲevʲɪr
клееобразный	klʲɪɪɐbˈraz̪n̪ɨɪ̯
клей	klʲɪˈi
клеймо	klʲɪjˈmo
клеть	klʲetʲ
клизма	ˈklʲizmɐ
клик	klʲik
климакс	ˈklʲiməksɨ
клин	klʲin
клип	kɫʲip
клитор	ˈklʲitər
кличка	ˈklʲit͡ɕkə
клоака	kɫ̪ɐˈäkʲɪ
клок	kɫɐˈkʲiˈkɫot͡ɕjə
клонирование	klənʲɪrəvənʲɪjɪ
клуб	kɫup
клубника	kɫʊbˈnʲikʲɪ
клык	klɨˈkʲɪ
ключ	klʲʉʨ
клятва	ˈklʲät̪və
клёкот	ˈklʲɵkət
кнехт	ˈknʲextɨ
книга	ˈknʲigʲɪ
книжица	ˈknʲiʐɨt͡sə
книжка	ˈknʲiʂkʲɪ
кнопка	ˈknopkʲɪ
княжна	knʲɪˈʐna
князь	knʲæsʲ
князёк	knʲɪˈzʲɵk
кобель	kəbʲɪˈlʲi
кобра	ˈkobrə
кобыла	kɐˈbɨɫə
коваль	kɐˈvalʲ
ковкость	ˈkofkəsʲtʲɪ
ковёр	kɐˈvʲɵ̞r
когорта	kɐˈgortɘ
кодек	ˈkodɛkʲɪ
кожа	ˈkoʐə
кожух	kəʐuˈxʲikəʐuˈxa
козелок	kəzʲɪlˈkʲi
козинак	kɐzʲɪˈnakʲɪ
кознь	kozʲnʲ
козёл	kɐˈzʲɵɫ̪
койлель	kɐɪ̯ˈlʲelʲ
койот	kɐˈjot
кокошник	kɐˈkoʂnʲɪkʲɪ
колба	kɐɫˈbɨ
колдун	kɐɫˈdun
коленвал	kəlʲɪnvɐˈɫɨ
колесо	kəlʲɪˈso
колея	kəlʲɪˈjæ
колик	ˈko̞lʲɪkʲɪ
колика	ˈko̞lʲɪkə
количество	kɐˈlʲiʨɪstvə
коллапс	kɐˈɫapsɨ
коллекционирование	kəlʲɪktsɨɐˈnʲirəvənʲɪjə
коллетида	kəlʲɪˈtʲidɨ
коллизия	kɐˈlʲizʲɪjə
коловратка	kʌɫʌvˈratki
колодец	kɐˈɫotsɨ
колокол	ˈkoɫəkəɫ
колокольчик	kəɫɐˈkolʲʨɪk
колонка	kɐˈɫonkə
колонна	kɐˈɫonːə
колос	ˈkoɫəs
колот	ˈkoɫət
колотовка	kəɫɐˈtofkə
колотушка	kəɫɐˈtuʂkʲɪ
колпачок	kəɫpɐˈʨkʲɪ
колыбель	kəɫɨˈbʲelʲɪ
кольцо	ˈkolʲt͡sə
кольчуга	kɐlʲˈʨʉgʲɪ
кольчужник	kɐlʲˈt͡ɕuʐnʲɪk
колюр	kɐˈlʲʉr
колючка	kɐˈlʲʉt͡ɕkə
кома	ˈkomɨ
командир	kəmɐnʲˈdʲirɨ
комбинат	kəmbʲɪˈnat
комета	kɐˈmʲetɨ
комик	ˈko̞mʲɪk
комиссия	kɐˈmʲisʲɪjɪ
комитет	kɐmʲɪˈtʲetɨ
коммент	ˈko̞mʲɪn̪t̪ɨ
коммерциализация	kəmʲɪrtsɨəlʲɪˈzatsɨjə
коммуницирование	kəmʊnʲɪˈt͡sɨrəvənʲɪjə
коммуняка	kəmʊˈnʲakə
компаньон	kəmpɐnʲˈjɵn
компас	ˈkompəsɨ
компаундирование	kəmpəʊnʲˈdʲirəvənʲɪjə
компендиум	kɐmˈpʲenʲdʲɪʊm
компетенция	kəmpʲɪˈtʲent͡sɨjə
компиляция	kəmʲpʲɪˈlʲat͡sɨɪ
комплекс	ˈkomplʲɪksɨ
комплексный	ˈkomplʲɪksnɨjə
компот	kɐmˈpot̪ɨ
комсомолец	kəmsɐˈmolʲtsɨ
комяжник	kɐˈmʲaʐnʲɪk
конвейер	kɐnˈvʲejɪrɨ
конвивиум	kɐn̪ˈvʲivʲɪʊmɨ
конвоир	kən̪vɐˈirɨ
конвой	kɐn̪ˈvoɪ̯
конгруэнтный	kənɡrʊˈɛntnɨjɪ
кондитерская	kɐnʲˈdʲitʲɪrskʲɪjə
кондиционер	kənʲdʲɪt͡sɨɐˈnʲer
коневод	kənʲɪˈvot
конец	kɐˈnʲets
конечность	kɐˈnʲeʨnəsʲtʲɪ
конина	kɐˈnʲinə
конкуренция	kənkʊˈrʲent͡sɨjɪ
конкурс	ˈkonkʊrsɨ
конник	ˈko̞nːɪkʲɪ
коновал	kənɐˈvaɫ
коноплянка	kɐn̪ɐˈplʲan̪kʲɪ
коносамент	kənəsɐˈmʲentɨ
конспект	kɐnsˈpʲektɨ
константа	kɐnˈstantə
конструктор	kɐnˈstruktərɨ
конструкция	kɐnˈstruktsɨɪ
консьерж	kɐn̻ˈsʲjerʂ
контекст	kɐnʲˈtʲekst
контент	kɐnˈtɛntɨ
континент	kənʲtʲɪˈnʲentɨ
конторка	kɐnˈtorkə
контра	ˈko̞ntrɨ
контрабас	kəntrɐˈbasɨ
контрамарка	kontrɐˈmarkə
контратака	ˌkontrɐˈtakʲɪkəntrɐˈtakʲɪ
контрацептив	kəntrətsɪpˈtʲivɨ
контргайка	kɐntrˈɡajkə
контроль	kɐnˈtrolʲ
конфигурация	kənfʲɪgʊˈratsɪjə
конфликт	kɐnˈflʲikt
конфорка	kɐn̪ˈfo̞rkʲɪ
концепция	kɐnˈtsɛptsɪjə
концлагерь	kɐn̻t͡sˈɫagʲɪrʲ
кончина	kɐˈtɕinɐ
конь	ˈkonʲɪ
конькобежец	kənʲkɐˈbʲeʐɨt͡s
коньяк	kənʲjʌˈkʲi
коньячок	kənʲjɪˈt͡ɕɵk
конюшня	kɐˈn̪ʲʉ̞ʂn̪ʲɪ
конёк	kɐˈnʲɵk
копейка	kɐˈpʲeɪ̯kə
коперниций	kəpʲɪrˈnʲitsɨj
копирование	kɐˈpʲirəvənʲɪjə
копра	ˈkoprə
копчик	ˈkopʨɪkʲɪ
кора	ˈko̞rɨ
кораблекрушение	kɐˌrəblʲɪkrʊˈʂɛnɪɛ̝
корабль	kɐˈrablʲ
коралл	kɐˈraɫ
корень	ˈko̞rnʲɪkɐˈrʲenʲjə
корешок	kərʲɪʂˈkʲi
корзина	kɐrˈzʲinə
кориандр	kərʲɪˈandrɨ
коринка	kɐˈrʲinkə
корица	kɐˈrʲit͡sə
корнет	kɐrˈnʲɛtɨ
коробка	kɐˈropkʲɪ
корова	kɐˈrovə
короед	kɒrɒˈjet
королевич	kərɐˈlʲevʲɪt͡ɕɪ
корона	kɐˈronə
коростель	kərɐsʲˈtʲelʲ
корпоратив	kərpərɐˈtʲivɨ
корпус	ˈkorpʊsɨkərpʊˈsa
корраль	kɐˈrːälʲ
коррелят	kərʲɪˈlʲætɨ
корреспондент	kərʲispɐnʲˈdʲent
корт	ˈko̞rtɨ
кортеж	kɐrˈtɛʂ
кортик	ˈkoɾtʲɪk
корча	ˈkoɾtɕɪ
корчмарь	kərʨmɐˈrʲi
корыто	kɐˈrɨtə
коса	ˈkosɨ
космизация	kəsmʲɪˈzat͡sɨjə
космонавт	kəsmɐˈnaftɨ
космополит	kəsməpɐˈlʲit
космополитизм	kəsməpəlʲɪˈtʲizm
космополитичный	kəsməpəlʲɪˈtiʨnɨj
космополитка	kəsməpəlʲɪˈtkɐ
костодробилка	kəs̪t̪əd̪rɐˈbʲiɫ̪kʲɪ
костромской	kəstrɐmˈskʲijɪ
костыль	kɐsˈtɨlʲ
кость	ˈkosʲtʲɪ
костёл	kɐˈsʲtʲɵɫ
костёр	kɐs̪ˈtʲɵr
косуля	kɐˈsulʲɪ
косуха	kɐˈsuxʲɪ
косушка	kɐˈsuʂkə
косяк	kəsʲɪˈkʲi
кот	kɐˈtɨ
котлета	kɐtˈlʲetɨ
котлетка	kɐtˈlʲetkə
котлован	kət̪ɫ̪ɐˈvän̪
котловина	kət̪ɫ̪ɐˈvʲin̪ə
который	kəˈtorɨj
котёл	kɐˈtʲɵl
котёнок	kɐˈtʲætə
кофемолка	kəfʲɪˈmoɫkʲɪ
кочевник	kɐˈt͡ɕevnʲɪk
кочегар	kəʨɪˈgar
кочегарка	kət͡ɕɪˈgarkə
кочедык	kəʨɪˈdɨkʲɪ
кочерга	kəʨɪrˈga
кочка	ˈkot͡ɕkə
кош	ˈkoʂɨ
кошатник	kɐˈʂatnʲɪk
кошка	ˈkoʂkʲɪ
кошмар	kɐʂˈmarɨ
краб	ˈkrabɨ
кража	ˈkraʐə
край	krɐˈja
крамола	krɐˈmoɫɨ
краник	ˈkran̪ʲɪkʲɪ
крант	ˈkrantɨ
крапива	krɐˈpʲivə
крапивница	krɐˈpʲivnʲɪt͡sə
краса	krɐˈsa
красавчик	krɐˈsafʨɪk
краснобай	krəsnʌˈbajɪ
красотка	krɐˈs̪o̞t̪kʲɪ
краткость	ˈkratkəsʲtʲɪ
краудсорсинг	krəʊtˈsorsʲɪnk
краш-тест	krɐʂˈtɛstɨ
крашенка	ˈkraʂənkə
креатура	krʲɪɐˈturə
креветка	krʲɪˈvʲe̞tkə
кредит	ˈkrʲedʲitɨ
кредо	ˈkrɛdə
крем	ˈkrɛm
кремень	krʲɪˈmʲenʲ
кремнёвый	krʲɪˈmnʲovɨjə
крендель	krʲɪ̝nʲdʲɪ̝ˈlʲaˈkrʲenʲdʲɪ̝lʲɪ
крепость	ˈkrʲepəsʲtʲ
крепыш	krʲɪpɨˈʂɨ
кресло-качалка	ˈkrʲes̪ɫ̪əkɐˈt͡ɕäɫ̪kə
крест	krʲest
крестик	ˈkrʲestʲɪkʲɪ
крестраж	krʲɪsˈtraʐ
кретин	krʲɪˈtʲin̪
кретинизм	krʲɪtʲɪˈnʲizm
кривая	krʲɪˈvɨjə
криз	ˈkrʲizɨ
кризис	ˈkrʲizʲɪs
крик	krʲik
криптография	krʲɪpt̪ɐˈgrafʲɪjə
криптон	krʲɪpˈtonɨ
кристалл	krʲɪˈstaɫɨ
критерий	krʲɪˈtɛrʲɪː
кров	krof
кровать	krɐˈvɑtʲ
кровник	ˈkrovnʲɪkʲɪ
кровопролитие	krəvəprɐˈlʲitʲɪjə
кровотечение	krɐvɐtʲɪˈtɕɛnʲɪɨ
кровоток	krəvɐˈtokʲɪ
кровь	kro̞fʲ
крокодил	krəkɐˈdʲiɫ
крокус	ˈkrokʊsɨ
крольчиха	krɐlʲˈʨixa
крольчонок	krɐlʲˈtɕatə
крошка	ˈkroʂkʲɪ
круассан	krʊɐˈsanɨ
круг	krʊˈgʲi
круглогубцы	krʊgɫɐˈguptsɨ
кругляшка	krʊgˈlʲæʂkə
кругосветка	krʊgɐˈsvʲetkʲɪ
кружало	krʊˈʐaɫə
кружево	krʊʐəˈva
кружок	krʊˈʐok
крунер	ˈkrunʲɪr
крупа	krʊˈpa
кручина	krʊˈt͡ɕinə
крушение	krʊˈʂɛnʲɪjə
крыжовник	krɨˈʐovnʲɪkʲi
крыло	ˈkrɨlʲjə
крыса	ˈkrɨsə
крыша	ˈkrɨʂɨ̞
крюк	ˈkrʲʉk
кряква	ˈkrʲækvɨ
ксенон	ksʲɪˈnonɨ
ксенофоб	ksʲɪnɐˈfobɨ
ксенофобия	ksʲɪnɐˈfobʲɪjɪ
ксерокс	ˈksʲerəksɨ
ксива	ˈksʲivə
ксёндз	ksʲɪnˈdzɨ
ктырь	kt̪ɨrʲ
кубло	ˈkublə
кубышка	kʊˈbɨʂkʲɪ
кувалда	kʊˈvaɫd̪ɨ
кувез	kʊˈvʲes
кувшин	kʊfˈʂɨn
кудри	ˈkudrʲɪ
кузнец	kʊzʲˈnʲets
кузнечик	kʊzʲˈnʲeʨɪkʲɪ
кузовщина	kʊzɐfˈɕinə
кукуруза	kʊkʊˈruzə
кукурузник	kʊkʊˈruz̪n̪ɪkʲɪ
кукушка	kʊˈkuʂkʲɪ
кукша	ˈkukʂə
кулачище	kʊɫ̪ɐˈt͡ɕiɕːɪ
кулеш	kʊlʲɪˈʂɨ
кулич	kʊlʲɪˈʨi
кулхацкер	kʊɫ̪ˈxät͡skʲɪr
куль	kuɫ̪ʲ
кульминация	kʊlʲmʲɪˈnatsɨɪ
культовость	ˈkulʲt̪əvəsʲtʲ
культура	kʊlʲˈturə
кулёма	kʊˈlʲɵmɨ
кулёчек	kʊˈɫ̪ʲɵt͡ɕkʲɪ
кум	kʊˈmovʲja
кумачовый	kʉmɐˈʨɵvɨjə
кумбиямба	kʊmbʲɪˈjämbɨ
кумкват	kʊmˈkvat
кунак	kʊnɐˈki
куница	kʊˈnʲitsə
кунка	ˈkun̪kˈɪ
куночка	ˈkun̪ət͡ɕkə
купание	kʊˈpanʲɪjə
купе	kʊˈpɛ
купец	kʊpˈt͡sɨ
купол	kʊpɐˈla
купюра	kʊˈpʲʉrɨ
кур	ˈkur
курд	ˈkurdɨ
курдюк	kʊrˈdʲʉk
курень	kʊrʲɪˈnʲi
курильщица	kʊˈrʲilʲɕɪtsɨ
курок	kʊrˈki
куртка	ˈkurtkʲɪ
куряка	kʊˈrʲäkə
курятник	kʊˈrʲætnʲɪkʲɪ
курящий	kʊˈrʲæɕːɪjəkʊˈrʲæɕːɪː
кускус	kʊsˈkus
кутерьма	kʊtʲɪ̝rʲˈmɨ
кутузка	kʊˈtuskə
кутёж	kʊtʲɪˈʐɨ
куча	ˈkutɕə
кущение	kʊˈɕːenʲɪ̝jə
кэб	ˈkebɨ
лабиализация	ɫəbʲɪəlʲɪˈzatsɨɪ
лабиринт	ɫəbʲɪˈrʲint
лаборатория	ɫ̪əbərɐˈt̪o̞rʲɪː
лаванда	ɫɐˈvandə
лаваш	ɫɐˈvaʂ
лавка	ˈɫɑfkə
лавочник	ˈɫavəʨnʲɪk
лавэ	ɫ̪ɐˈvɛ
лаг	ˈɫagʲɪ
лагерник	ˈɫagʲɪrnʲɪk
лад	ɫɐˈdɨ
лада	ˈɫadɨ
ладан	ˈɫɑdənɨ
ладанка	ˈɫɑdən̪kʲɪ
ладок	ɫɐt̪ˈkʲi
ладонь	ɫɐˈdonʲɪ
ладья	ɫɐˈdʲjä
лажа	ˈɫ̪aʐə
лазанья	lɐˈzanʲɪ̯ɪ
лазарет	ɫɐzɐˈrʲɛt
лазоревка	ɫɐˈzorʲɪfkʲɪ
лазурь	ɫ̪ɐˈz̪urʲɪ
лай	ˈɫ̪äɪ
лайк	laɪ̯k
лайка	ˈlajkə
лайм	ˈɫaɪ̯mɨ
лайн-ап	ɫɐɪ̯ˈnap
лакей	ɫɐˈkʲeɪ
лакмус	ˈɫakmʊs
лама	ˈɫamɨ
ламантин	ɫəmɐnʲˈtʲinɨ
лампа	ˈɫɑmpə
лампада	lɐmˈpadɨ
ландо	lɐnˈdo
ландшафт	lɐnˈʂaft
ланита	ɫɐˈnʲitɨ
лантаноид	ɫəntɐˈnoɪt
лань	ɫanʲ
лапка	ˈɫɑpkə
лапта	ɫ̪ɐpˈtä
ларёк	lʌˈrʲo̞k
ласка	ˈɫaskə
ластик	ˈɫɑsʲtʲɪkʲɪ
ласточка	ˈɫɑstət͡ɕkə
лат	ˈɫatɨ
латиница	ɫɐˈtʲinʲɪtsɪ
латник	ˈɫatnʲɪk
латынь	ɫɐˈtɨnʲɪ
лафет	ɫɐˈfʲetɨ
лафитник	ɫɐˈfʲitnʲɪk
лафтак	ɫəft̪ɐˈkʲi
лачуга	ɫɐˈʨʉgʲɪ
лбище	ˈlbʲiɕːɪ
лганьё	lgɐˈnʲjo̞
лебедь	ˈlʲebʲɪdʲɪ
лебёдка	lʲɪˈbʲɵtkʲɪ
лев	lʲef
левкой	lʲɪfˈkoɪ̯
левша	lʲɪfˈʂa
легавый	lʲɪˈgävɨɪ̯
легковерность	lʲɪxkɐˈvʲernəsʲtʲɪ
леденец	lʲɪdʲɪnˈtsɨ
леди	ˈlʲedʲɪ
лежбище	ˈlʲeʐbʲɪɕːə
лезгин	lʲɪzˈgʲinɨ
лезгинка	lʲɪzˈgʲinkə
лейб-гвардеец	lʲɛjpɡvaɾˈdʲɛɪts
лейб-драгун	lʲɛjbdrɐˈɡun
лейнер	ˈlʲeɪ̯nɛrɨ
лейтенант	lʲɪtʲɪˈnantɨ
лекарство	ˈlʲekərstvə
лекарь	ˈlʲekərʲɪlʲɪkɐˈrʲæ
лексема	lʲɪkˈsɛmɨ
лексика	ˈlʲeksʲɪkə
лексикография	ˌlʲeksʲɪkɐˈɡrafʲɪɪ
лексикология	lʲɪksʲɪkɐˈlogʲɪː
лексикостатистика	lʲeksʲɪkəstɐˈtʲisʲtʲɪkʲɪ
лектор	ˈlʲektər
лемонграсс	lʲɪmɐn̪ˈɡras̪
лемур	lʲɪˈmurɨ
ленивец	lʲɪˈnʲift͡sɨ
ленточка	ˈlʲentəʨkʲɪ
лентяй	lʲɪnʲˈtʲæɪ
лентяйка	lʲɪnʲˈtʲæjkə
ленч	ˈlʲen̪t͡ɕɪ
леопард	lʲɪɐˈpart
леотард	ɫʲɪɐˈtart
лепесток	lʲɪpʲɪst̪ˈkʲi
лепота	lʲɪpɐˈta
лептон	lʲɪpˈtonɨ
лепёшка	lʲɪˈpʲɵʂkə
леса	ˈɫ̪ʲes̪ɨ
лесбиянка	lʲɪzbʲɪˈjankə
лесостепь	lʲɪsɐˈsʲtʲepʲ
лестовка	ˈlʲestəfkə
лето	ˈlʲetə
летопись	ˈlʲetəpʲɪsʲ
леший	ˈlʲeʂɨɪ̯ə
лещ	lʲeɕː
лжевсезнайка	ˌɫʐɛfsʲɪˈz̪n̪aɪ̯kə
ли	lʲi
либерал	lʲɪbʲɪˈralɨ
либераст	lʲɪbʲɪˈrast
либериец	lʲɪbʲɪˈrʲijtsɨ
либерийка	lʲɪbʲɪˈrʲijkʲɪ
ливень	ˈlʲivʲɪnʲ
ливерморий	lɨvʲɨrˈmorʲɨɪ
ливрея	lʲɪvˈrʲeɪ
лига	ˈlʲigʲɪ
ликвидация	lʲɪkvʲɪˈdatsɨɪ
лиман	lʲɪˈmɑnɨ
лимонен	lʲɪmɐˈnɛn
лимоновец	lʲɪˈmonəvʲɪts
лимузин	lʲɪmʊˈzʲinɨ
лингвистика	lʲɪn̪ɡˈvʲisʲtʲɪkʲɪ
линеаризуемость	lʲɪnʲɪərɪˈzujeməsʲtʲ
линза	ˈlʲinzɨ
линёк	lʲɪˈnʲɵk
липид	lʲɪˈpʲit
лис	lʲis
лиса	ˈlʲisɨ̞
лисапед	lʲɪsɐˈpʲedɨ
лисичка	lʲiˈsʲitʃki
лист	lʲist
листовка	lʲɪsˈtofkə
листомания	lʲɪs̪t̪ɐˈmanʲɪɪ
листопад	lʲɪstɐˈpadɨ
литейный	lʲɪˈtʲejnɨj
литературовед	lʲɪtʲɪrətʊrɐˈvʲet
литовец	lʲɪˈtoftsɨ
литовка	lʲɪˈtofkʲɪ
литория	lʲɪˈtorʲɪɪ̯ə
литрбол	lʲɪt̪rˈbo̞ɫ̪
литургия	lʲɪtʊrˈgʲijɪ
лихорадка	lʲɪhəˈratkə
лицей	lʲɪˈtsɛɪ
лицензионный	lʲɪt͡sɨnzʲɪˈonːɨj
лицензия	lʲɪˈt͡sɛnʲzʲɪjə
лицо	ˈlʲitsə
личинка	lʲɪˈʨinkə
личка	ˈlʲit͡ɕkʲɪ
лишай	lʲɪˈʂaj
лишайник	lʲɪˈʂaɪnʲɪ̝kʲɪ
лоб	ɫop
лоббизм	lɐˈbʲizmɨ
лобок	ɫɐbˈkʲi
лоботряс	ɫəbɐˈtrʲæsɨ
лобстер	ˈɫopstərɨ
лов	ɫof
ловкость	ˈɫofkəsʲtʲ
ловушка	ɫ̪ɐˈvuʂkə
логарифм	ɫəgɐˈrʲifm
логика	ˈɫ̪oɡʲɪkə
логин	lɐˈɡʲin
лодка	ˈɫo̞t̪kʲɪ
лодочка	ˈɫ̪od̪ət͡ɕkʲɪ
лодырь	ˈlodɨrʲɪ
ложа	ˈɫoʐɨ
ложка	ˈɫoʂkə
ложь	ˈɫoʂ
лозняк	ɫ̪ɐz̪ˈnʲak
локус	ˈɫokʊsɨ
лол	ɫoɫ
лоликон	ləlʲɪˈkonɨ
ломоть	ɫɐˈmotʲ
лоно	ˈɫonə
лопата	ləˈpatə
лорд	ˈɫordɨ
лорнет	ɫɐrˈnʲetɫɐrˈnɛt
лоск	ˈɫoskʲɪ
лосось	ɫɐˈsosʲ
лот	ˈɫotɨ
лотошник	ɫɐˈtoʂnʲɪkʲɪ
лофер	ˈɫofʲɪrɨ
лофт	ɫoft
лох	ˈɫ̪o̞xʲɪ
лохмотья	ɫ̪ɐxˈmotʲjə
лохотрон	ɫəxɐˈt̪ron̪
лошадник	ɫɐˈʂadnʲɪkʲɪ
лошак	ɫɐˈʂɑk
лубок	ɫʊpˈkʲi
лубутен	ɫʊbʊˈtɛnɨ
луг	lʊˈɡa
луддит	lʊˈdʲitɨ
лужа	ˈluʐɨ
лузер	ˈɫuzʲɪrɨ
лукоморье	lukəˈmorʲjə
лукошко	ɫʊˈkoʂkʲɪ
луна	ɫʊˈna
лупсенция	ɫʊˈpsʲen̪t͡sɨjə
лучник	ˈlutʃnʲɪkʲɪ
лучок	ɫʊˈt͡ɕɵk
лыва	ˈɫ̪ɨvɨ
лыжня	ɫɨʐˈnʲa
лыко	ˈɫɨkʲɪ
лында	ˈlɨndɨ
лысина	ˈlɨsʲɪnɨ
лыска	ˈlɨskə
львица	ˈlʲvʲitsə
льгота	ˈlʲgotɨ
любимый	lʲʉˈbʲimɨjə
любительский	lʲʉˈbʲitʲɪlʲskʲɪj
любовь	lʲʉˈbvʲi
любодеяние	lʲʉbɐdʲɪˈjænʲɪjə
любострастие	lʲʊbɐˈs̪t̪rasʲtʲɪɪ̯ə
люди	ˈlʲʉdʲɪ
людоед	lʲʉdɐˈjet
люк	ˈlʲʉkʲɪ
люцерна	lʲʉˈtsɛrnə
ля-бемоль	lʲæbʲɪmˈolʲɪ
ля-диез	lʲædiˈɛs
лягушка	lʲɪˈguʂkʲɪ
лямка	ˈlʲæmkʲɪ
ляпалиссиада	lʲɐpɐlʲɪsʲːɪˈad̪ə
лёд	lʲo̞t
лён	lʲɵn̪
мавзолей	məvzɐˈlʲeɪ
мавка	ˈmavkə
мавр	ˈmavrɨ
мавродик	mɐˈvrodʲɪk
магазин	məgɐˈzʲinɨ
магистр	mɐˈgʲistər
магистрат	məgʲɪˈstrɑtɨ
магма	ˈmagmə
магнетит	mɐgnʲɪˈtʲitɨ
магнолия	mɐgˈnolʲɪː
мажор	mɐˈʐorɨ
мазик	ˈmazʲɪkʲɪ
мазня	mʌˈzʲnʲi
мазок	mɐˈz̪ok
мазохизм	məzɐˈxʲizmɨ
майдан	mɐjˈdanɨ
майдановец	mɐɪ̯ˈd̪an̪əft͡sɨ
майка	ˈmaɪ̯kʲɪ
майор	mɐˈjor
макарена	məkɐˈrɛnɨ
макияж	məkʲɪˈjæʐɨ
маковник	ˈmäkəvnʲɪkʲɪ
макровызов	ˌmakrɐˈvɨzəvɨ
максилла	məksʲɪlɨ
малафья	mɐɫ̪ɐˈfʲɪ̯i
малахай	məɫɐˈxaɪ
малахит	məɫɐˈxʲit
малина	mɐˈlʲin̪ɨ
малодушие	mɐɫ̪ɐˈd̪uʂɨɪ̯ə
малорослый	məlɐˈroslɨj
малый	ˈmaɫɨ̞j
мальгашский	mɑlʲˈgɐʃskʲij
мамлюк	mɐmˈlʲʉkʲɪ
мамонт	ˈmaməntɨ
мамура	mɐˈmurə
манго	ˈmangə
манда	mɐnˈda
мандавошка	mən̪d̪ɐˈvo̞ʂkʲɪ
мандала	mɐnˈdalɨ
мандат	mɐnˈdatɨ
мандибула	mɐn̪ˈdʲibʊɫ̪ə
манеж	mɐˈnʲeʂ
манекен	mənʲɪˈkʲenɨ
мани	ˈmanʲɪ
манипулятор	mənʲɪpʊˈlʲatərɨ
манка	ˈmɑnkʲɪ
мансарда	mɐnˈsardɨ
мант	ˈmɑntɨ
манта	ˈmɑntɨ
мантикора	mənʲtʲɪˈkorɨ
мантия	ˈmanʲtʲɪjə
маньчжур	mɐnˈd͡ʑurɨ
маракуйя	mərɐˈkuɪ̯ə
марганец	ˈmargənʲɪts
маргарин	mərgɐˈrʲinɨ
маржа	mɐrˈʐaˈmarʐə
маринизм	mərʲɪˈnʲizm
маркер	ˈmarkʲərɨ
маркиз	mɐrˈkis
марксизм-ленинизм	mʌrkˈsʲɪzmlʲənʲɪˈnʲɪzm
маркёр	mɐrˈkʲɵrɨ
марлинь	ˈmɑrlʲɪnʲɪ
марля	mɑrlʲə
мародёрство	mɐrɐˈd̪ʲɵrs̪t̪və
марризм	mɐˈrʲizm
марсианин	mərsʲɪˈanɛ
март	mɑrt
мартышка	mɐrˈtɨʂkə
маска	ˈmaskə
маскулинность	mɐs̪kʊˈlʲin̪ːəsʲtʲɪ
масленица	ˈmaslʲɪnʲɪt͡sə
маслина	mɐˈs̪lʲin̪ə
масло	mɐˈs̪ɫ̪ä
массаж	mɐˈsːaʂ
мат	mät̪
матереубийство	mɐtʲɪrʲɪʊˈbʲijstvə
матереубийца	mɐtʲɪrʲɪʊˈbʲitɕɨ
материк	mətʲɪˈrʲik
материя	mɐˈtʲerʲɪɪ̯ə
матрац	mɐt̪ˈrat͡s
матрёшка	mɐtˈrʲɵʂkə
маффин	ˈmafʲːɪn
маца	mɐˈt͡sä
мацони	mɐˈt͡sonʲɪ
мачеха	ˈmat͡ɕɪxə
машина	mɐˈʂɨnə
машинерия	məʂɪˈnʲerʲɪjəməʂɪˈn̪ɛrʲɪjə
маэстро	mɐˈɛstro
маячок	məɪˈt͡ɕok
маёвка	mɐˈjɵfkə
мгла	mgɫɨ
мебель	ˈmʲebʲɪlʲɪ
мегагерц	mʲɪgɐˈgʲert͡sɨ
медаль	mʲɪˈdɑlʲɪ
медведь	mʲɪdˈvʲetʲ
медиана	mʲɪdʲɪän̪ɨ
медиапроигрыватель	ˌmʲedʲɪəprɐˈiɡrɨvətʲɪlʲɪ
медицина	mʲɪdʲɪˈtsɨnə
медовый	mɪˈdovɨj
медь	ˈmʲedʲɪ
медяк	mʲɪˈdʲæk
межа	mʲɪˈʐa
междометие	mʲɪʐdɐˈmʲetʲɪjə
межеумок	mʲɪʐɨˈumək
межсоединение	ˌmʲeʂsəjɪdʲɪˈnʲenʲɪjə
мезозой	mʲɪzɐˈzoɪ
мезонин	mʲɪzɐˈnʲinɨ
мейджор	ˈmɛɪ̯d͡ʑər
мейтнерий	mʲɪjtˈnɛrʲɪj
мектеб	mʲɪkˈtɛbɨ
мел	mʲeɫ
меланома	mʲɪlɐˈnomɨ
мелодия	mʲɪˈɫodʲɪː
мель	ˈmʲelʲɪ
мельник	ˈmʲelʲnʲɪkʲɪ
мельница	ˈmʲelʲnʲɪtsə
мельничиха	ˈmʲelʲnʲɪʨɪxʲɪ
меморабилия	mʲɪmərɐˈbilʲɪɪ̯ə
мемуарист	mʲɪmʊɐˈrɪst
мемуары	mʲɪmʊˈaɾɨ
мена	ˈmʲenɨ
ментовка	mʲɪnˈtofkə
мерзавец	mʲɪrˈzavʲɪts
меридиан	mʲɪrʲɪdʲɪˈanɨ
меристема	mʲɪrʲɪˈs̪t̪ɛmɨ
мероприятие	mʲɪrəprʲɪˈjætʲɪjə
мертвец	mʲɪrtvʲɪˈtsɨ
мертвецкая	mʲɪrtˈvʲetskəjə
мертвяк	mʲɪrtvʲɪˈkʲi
меря	ˈmʲerʲə
местечко	mʲɪsʲˈtʲeʨkə
место	mʲɪˈsta
местоимение	mʲɪstəɪˈmʲenʲɪjə
месть	ˈmʲesʲtʲɪ
месяц	ˈmʲesʲɪt͡s
месяцеслов	mʲɪsʲɪt͡sɨˈsɫovɨ
металлург	mʲɪtɐˈɫurk
металлургия	mʲɪtəɫʊrˈɡʲijə
метеор	mʲɪtʲɪˈorɨ
метеорит	mʲɪtʲɪɐˈrʲit
метка	ˈmʲetkə
метр	ˈmɛtrɨ
метресса	mʲɪtˈrɛsːɨ
метричка	mʲɪˈtrʲiʨkʲɪ
метро	mʲɪt̪ˈro̞
метрополитен	mʲɪtrəpəlʲɪˈtɛnɨ
метротрам	mʲɪt̪rɐˈt̪ram
мех	mʲɪˈxa
механизм	mʲɪxɐˈnʲizm
механика	mʲɪˈxanʲɪkʲɪ
меч	mʲɪˈt͡ɕi
мечеть	mʲɪˈtɕɛtʲ
мечта	mʲɪt͡ɕˈt̪ɨ
мешок	mʲɪʂˈkʲi
мещанин	mʲɪɕːɪˈnʲin
ми-бемоль	mʲibʲɪmˈolʲɪ
ми-диез	midiˈɛs
миг	mʲik
миграционизм	mʲɪɡrət͡sɨɐˈnʲizmɨ
мигрень	mʲɪˈgrʲenʲ
мидраш	mʲɪˈdraʂɨ
мизинец	mʲɪˈzʲint͡sɨ
микроб	mʲɪkˈrobɨ
микроблог	ˌmʲikrɐˈbɫoɡʲɪ
микроволновка	mʲɪkrəvɐˈɫn̪ofkə
микродиод	ˌmʲɪkrədʲɪˈot
микросекунда	mʲɪkrəsʲɪˈkundə
микрофон	mʲikrʌˈfonɨ
микрофонный	mʲɪkrɐˈfonnɨ̞jə
милашка	mʲɪˈɫɑʂkʲɪ
миллениал	mʲɪlʲɪnʲɪˈaɫɨ
милостисдарь	ˈmʲiɫəsʲtʲɪˈzdarʲ
милостыня	ˈmiləstɨnʲə
милочек	mʲiˈɫotɕkɪ
мим	mʲim
мимоза	mʲɪˈmozɨ
мина	ˈmʲinɨ
миндаль	mʲɪndɐˈlʲi
минерал	mʲɪnʲɪˈraɫ
миниатюра	mʲɪnʲɪɐtʲʉ̞rə
минивэн	mʲɪnʲɪˈvɛnɨ
минор	mʲɪˈnor
минтай	mʲɪnˈtɑj
минус	ˈmʲinʊsɨ
минускул	mʲɪˈn̪us̪kʊɫɨ
минута	mʲɪˈnutə
минчанка	mʲɪnʲˈt͡ɕænkə
миньон	mʲɪnʲˈjonɨ
мир	mʲɪˈrɨ̞
мираж	mʲɪrɐˈʐɨ
мирволение	mʲɪrˈvolʲɪnʲɪɪ̯ə
миротворец	mʲɪrɐˈtvorʲɪts
мирт	ˈmʲirtɨ
мистер	ˈmʲistər
митап	mʲɪˈt̪apɨ
миткаль	mʲɪt̪ˈkalʲ
митохондрия	mʲɪtɐˈχondrʲɪjə
миттельшпиль	ˈmʲitːɛlʲˌʂpʲilʲ
мичман	ˈmʲit͡ɕmənɨ
мичуринец	mʲɪˈtɕʉɾʲɪntsɨ
мишень	mʲɪˈʂɛnʲ
младенец	mɫɐˈdʲenʲɪts
младотурок	ˌmɫadɐˈturkʲɪmɫədɐˈturkʲɪ
млат	mɫɑt
млеко	ˈmlʲekə
многоборье	mnəgɐˈborʲjə
многогранный	mnəgɐˈgrannɨj
многозначительный	mnəgəznɐˈʨitʲɪlʲnɨj
многоножка	mn̻əgɐˈnoʂkə
многообещающий	mnəgəːbʲɪˈɕːæjʊɕːɪjə
многообразие	mn̪əɡəɐbˈräzʲɪɪ̯ə
многочисленный	mnəgɐˈʨislʲɪnɨjə
множество	ˈmno̞ʐɨ̞ctvə
мня	mnʲi
мобилизовать	məbʲɪlʲɪzɐˈvatʲ
мобильник	mɐˈbʲilʲnʲɪkʲɪ
мова	ˈmo̞vɨ
моветон	məvʲɪˈt̪o̞n̪ɨ
могила	mɐˈgʲiɫɨ
модель	mɐˈdɛlʲɪ
моджахед	mədʐɐˈxʲet̪
модуль	ˈmodʊlʲ
можжевельник	məʐːɨˈvʲelʲnʲɪkʲɪ
мозг	ˈmo̞sk
мозгоёб	məz̪ɡɐˈɪ̯jo̞bɨ
мозоль	mɐˈzolʲɪ
мокасин	məkɐˈsʲinɨ
мокрица	mɐkˈrʲitsɨ
молдаванка	məɫdɐˈvankʲɪ
молибден	məlʲɪbˈdɛnɨ
молитва	mɐˈlʲitvə
молл	ˈmoɫɨ
молния	ˈmolnʲɪjɪ
молодожён	məɫədɐˈʐon
молодёжь	məlɐˈdʲɵʐɨ
молозиво	mɐˈɫozʲɪvə
молокозавод	məɫəkəzɐˈvodɨ
молот	ˈmolətɨ
молочай	mɐɫ̪ɐˈt͡ɕaɪ̯
молочник	mɐˈɫot͡ɕnʲɪk
молочница	mɐˈɫoʨnʲɪtsɨ
молчун	mɐɫˈʨʉn
мольба	mɐlʲˈbɨ
мольберт	mɐlʲˈbʲertɨ
момордика	məmɐrˈdʲikə
монарх	mɐˈnarx
монастырь	mənɐsˈtɨrʲ
монах	mɐˈnax
монетница	mɐˈnʲetnʲɪtsɨ
монитор	mənʲɪˈtor
моноблок	mənɐˈbɫokʲɪˌmonɐˈbɫokʲɪ
моногород	ˌmonɐˈgorət
монолог	mənɐˈɫok
мононуклеар	mənənʊklʲɪˈarɨ
монотипия	mənɐˈtʲipʲɪː
монстрация	mɐn̪ˈs̪t̪rät͡sɨɪ̯ə
мопед	mɐˈpʲedɨ
моралфаг	mərɐɫˈfagʲɪ
мораль	mɐˈralʲɪ
морда	ˈmordɨ
морж	mɐrˈʐɨ
моржовый	mɐrˈʐovɨjɘ
мороз	mɐˈros
морозец	mɐˈrozʲɪts
морок	ˈmo̞rəkʲɪ
морфема	mɐrˈfʲemɨ
морфий	ˈmorfʲɪj
морфология	mərfɐˈɫ̪o̞ɡʲɪɪ̯ə
москаль	məs̪kɐˈlʲi
москвич	mɐskvʲɪˈtɕi
московский	mɐˈskofskʲɪj
мост	mɐsˈtɨ
мосток	mɐsˈtok
моток	mʌˈto̞k
мотороллер	mətɐˈrolʲːɪrɨ
мотоцикл	mətɐˈt͡sɨklɨ
мотыга	mɐˈtɨgə
мотылёк	mətɨlʲˈkʲi
моцион	mətsɨˈonɨ
мочь	mo̞t͡ɕ
мошенничество	mɐˈʂɛnʲːɪt͡ɕɪstvə
мошна	mɐʂˈn̪ä
мошонка	mɐˈʂonkʲɪ
мощность	ˈmoɕːnəsʲtʲɪ
моэль	mɐˈɛlʲɪ
мраз	mrɑs
мрамор	ˈmramər
муда	mʊˈd̪ä
мудак	mʊˈd̪ak
муди	ˈmudʲɪ
мудня	mʊd̪ˈn̪ʲi
мудо	mʊˈd̪o
муж	mʊˈʐjæmʊˈʐɨ
мужество	ˈmuʐɨstvə
мужеубийство	mʊʐɪʊˈbʲijstvə
мужеубийца	muʂɪʊˈbʲijtsɨ
мужик	mʊʐɨˈkʲi
мужчина	mʊˈɕːin̪ɨ
музей	mʊˈzʲeɪ
музей-заповедник	mʊˈzʲejzəpɐˈvʲednʲɪk
музыка	mʊˈzɨkʲɪ
музыкальность	mʊz̪ɨˈkalʲn̪əsʲtʲ
музыкант	mʊzɨˈkantɨ
мука	ˈmukə
мукомол	mʊkɐˈmoɫɨ
мулат	mʊˈɫatɨ
мульт	mulʲt̪
мультиварка	mʊlʲtʲɪˈvarkʲɪ
мультя	ˈmulʲtʲə
муляж	mʊlʲɪˈʐɨ
мундир	mʊnˈdʲirɨ
муравей	mʊrɐˈvʲej
мурзик	ˈmurzʲɪk
мурзилка	mʊrˈzʲiɫ̪kə
мурцовка	mʊrˈt͡sofkʲɪ
мусарня	mʊˈsarnʲɪ
мусат	mʊˈsatɨ
мускат	mʊsˈkat
мусульманин	mʊsʊlʲˈmanʲɪn
мусульманка	mʊsʊlʲˈmankɪ
мутант	mʊˈtɑntɨ
мутуализм	mʊtʊəˈlʲiz̪m
муфта	ˈmuftə
мухоловка	mʊxɐˈɫofkə
мучение	mʊˈtɕɛnʲɪjə
мушка	ˈmuɕkə
мушкет	mʊʂˈkʲet
мшара	ˈmʂarə
мыслитель	mɨ̞ˈsʲlʲitʲɪlʲ
мыслишка	mɨs⁽ʲ⁾ˈlʲiʂkʲɪ
мыт	ˈmɨt
мытарство	mɨˈtarstvə
мытьё	mɨtʲˈjo̞
мышак	mɨˈʂak
мышь	mɨʂ
мэм	mɛm
мэтр	ˈmɛtrɨ
мюон	mʲʉˈon
мявканье	ˈmʲafkənʲɪ̯ə
мясник	mʲɒsniˈkɪ
мясо	ˈmʲæs̪ə
мята	ˈmʲætɨ
мятеж	mʲɪˈtʲeɕ
мёд	mʲɪˈd̪ɨ
набег	nɐˈbʲegʲɪ
набивка	nɐˈbʲifkə
набла	ˈnabɫə
наблюдатель	nəblʲʉˈdatʲɪlʲ
наборщик	nɐˈborɕːɪkʲɪ
набросок	nɐˈbroskʲɪ
навигация	nəvʲiˈgatsəjə
навка	ˈnavkʲɪ
наводнение	nəvɐdˈnʲenʲɪjə
наг	nag
нагайка	nɐˈɡajkʲɪ
нагорье	nɐˈgorʲjə
надгробие	nɐdˈɡrobʲɪje
наддув	nɐˈdːuf
надкус	nɐtˈkus
надлобье	nɐdˈɫobʲjə
надой	nɐˈdoj
надругательство	n̪ɐd̪rʊˈgat̪ʲɪɫ̪ʲs̪t̪və
надфиль	ˈnɑtfʲɪlʲ
надёжность	n̪ɐˈdʲɵʐn̪əsʲtʲɪ
наждак	nɐʐˈdak
название	nɐˈzvanʲɪjə
назидание	nəzʲɪˈdanʲɪ̝jə
наитие	nɐˈitʲɪjə
найдёныш	nɐjˈdʲɵnɨʂ
найтов	nɐjˈtovɨ
нака	ˈnakə
наказание	nəkɐˈzanʲɪjə
наклейка	nɐˈklʲeɪ̯kʲɪ
наклонность	nɐˈkɫonːəsʲtʲ
наколка	nɐˈkoɫkʲɪ
налаживание	nɐˈɫaʐɨvənʲɪjə
налив	nɐˈlʲivɨ
наличка	nɐˈlʲit͡ɕkə
налог	nɐˈɫoɡʲɪ
налой	nɐˈlojɪ
намаз	nɐˈmas
нанду	ˈnɑndʊ
нанобактерия	nənəbɐkˈtɛrʲɪːˌnanəbɐkˈtɛrʲɪː
нанобиология	ˌnanəbʲɪɐˈɫogʲɪː
наносник	nɐˈnosʲnʲɪk
нанотехнология	ˌn̪an̪ətʲɪxn̪ɐˈɫ̪o̞ɡʲɪː
нападение	nəpɐˈdʲenʲɪjə
напас	nɐˈpasɨ
напасик	nɐˈpasʲɪkʲɪ
напасть	nɐˈpasʲtʲɪ
напиток	nʌˈpʲitkʲɪ
напор	nɐˈporɨ
напёрсток	nɐˈpʲɵrstək
нарвал	nɐrˈvalɨ
нард	ˈnart
нарезка	nɐˈrʲeskʲɪ
наречие	nɐˈrʲeʨɪjə
нарик	ˈnarʲɪkʲɪ
наркодилер	nərkɐˈdʲilʲɪr
наркотик	nɐrˈkotʲɪk
народ	nɐˈrot
нарратив	nərɐtʲˈivɨ
нарцисс	nɐrˈtsɨs
наряд	nɐˈrʲäd̪ɨ
нарядчик	nɐˈrʲædtɕɪkɪ
наскок	nɐˈskok
наслаждение	nəsɫɐʐˈdʲenʲɪjə
насморк	ˈnasmərk
настройка	nɐˈstrojkə
насупившийся	n̪ɐs̪úpʲɪfʂɨjsʲə
натиск	ˈnatʲɪsk
натоптыш	nɐˈtoptɨʂɨ
натыльник	nɐˈtɨlʲnʲɪk
наука	n̪ɐˈukʲɪ
наушник	nɐˈuʂnʲɪk
нахал	nɐˈxaɫɨ̞
находка	nɐˈxotkə
находчивость	nɐˈxotʨɪvəsʲtʲɪ
нацизм	nɐˈtsɨzmɨ
национализм	nətsɨənɐˈlʲizm
нация	ˈnatsɪjə
нацмен	nɐt͡sˈmʲenɨ
начал	nɐˈt͡ɕæɫɨ
начало	nɐˈʨaɫə
начинание	nət͡ɕɪˈnanʲɪjə
нашатырь	nəʂətɨˈrʲi
наём	naˈjom
небо	ˈnʲebə
небожитель	nʲɪbɐˈʐɨtʲɪlʲ
небоскрёб	nʲɪbɐˈskrʲɵbɨ
небрежение	nʲɪbrʲɪˈʐɛnʲɪjə
небылица	nʲɪbɨˈlʲitsə
невеста	nʲɪˈvʲestə
невестка	nʲɪˈvʲes̪t̪kə
невидимка	nʲɪvʲɪˈdʲimkʲɪ
невидимый	nʲɪˈvʲidʲɪmɨjə
невма	ˈnʲevmə
невменоз	nʲɪvmʲɪˈn̪os̪
невольница	nʲɪˈvolʲnʲɪt͡sə
неврастеник	nʲɪvrɐsˈtʲɛnʲɪkɪ
неврология	nʲevrɐˈɫogʲɪjə
нега	ˈnʲegə
негатив	nʲɪɡɐˈtʲivɨ
негр	nʲeɡr
негритос	nʲgrʲɪˈtosɨ
негритянка	nʲɪgrʲɪˈtʲankʲɪ
неделя	nʲɪˈdʲelʲɪ
недоносок	nʲɪdɐˈnoskʲɪ
недопонимание	nʲɪdəpənʲɪˈmɑnʲɪjə
недопустимость	nʲɪdəpʊˈsʲtʲiməsʲtʲɪ
недоразумение	nʲɪdərəzʊˈmʲenʲɪjə
недоумок	nʲɪdɐˈumək
нежить	ˈnʲeʐɨtʲɪ
незабудка	nʲɪzɐˈbutkʲɪ
нездоровье	nʲɪzdɐˈrovʲjə
незначительный	nʲɪznɐˈʨitʲɪlʲnɨjə
неизбежный	nʲɪːzˈbʲeʐn̻ɨɪ̯
неизвестность	nʲɪɪzˈvʲesnəsʲtʲɪ
нейзильбер	n̪ʲeɪ̯ˈzʲilʲbʲərɨ
нейростимулятор	ˌnʲeɪ̯rəsʲtʲɪmʊˈlʲatər
нейтрон	nʲɪjˈtronɨ
некролог	nʲɪkrɐˈɫ̪o̞ɡʲɪ
некрополь	nʲɪkˈropəlʲ
нектар	nʲɪˈktarɨ̞
некурящий	nʲɪkʊˈrʲæɕːɪjənʲɪkʊˈrʲæɕːɪː
нелепица	nʲɪˈlʲepʲɪt͡sə
немец	ˈnʲemʲɪts
немота	nʲɪˈmotɨ
ненавидимый	nʲɪnɐˈvʲidʲɪmʲɨj
ненависть	ˈnʲenəvʲɪsʲtʲɪ
необходимость	nʲɪəpxɐˈdʲiməsʲtʲ
неодушевлённый	neʲədʊʂɪvˈlʲɵnːɨj
неологизм	nʲɪəɫɐˈɡʲizm
неон	nʲɪˈonɨ
непогода	nʲɪpɐˈgodɨ
неподвижность	nʲɪpɐˈdvʲiʐnəsʲtʲɪ
непоседа	nʲipʌˈsʲedɨ
непотизм	nʲɪpɐˈtʲiz̪m
непрерывность	nʲɪptʲɪˈrɨvnəsʲtʲɪ
неприглядный	nʲɪprʲɪˈglʲædnɨjə
неприятель	nʲɪprʲɪˈjætʲɪlʲ
неприятность	nʲɪprʲɪˈjætnəsʲtʲɪ
неразбериха	nʲɪrəzʲbʲɪ̝ˈrʲixə
нервотрёпка	ˌnʲirvʌˈtrʲo̞pkʲɪ
нерест	ˈnʲerʲəstɨ
нерусь	ˈnʲerʊsʲ
неслух	ˈnʲeslux
несовместимость	nʲɪsəvmʲɪˈsʲtʲiməsʲtʲ
нет	nɛt
нетбук	nɛdˈbuk
неувязка	nʲɪʊˈvʲæskʲɪ
неумойка	nʲɪʊˈmo̞jkə
неурядица	nʲɪʊˈrʲædʲɪtsə
неустойчивый	nʲɪʊˈstojʨɪvɨjə
неф	ˈnʲɛfɨ̞
нефрит	nʲɪˈfrʲit
нефть	ˈnʲeftʲɪ
нехороший	nʲɪxɐˈroʂɨj
нехристь	ˈnʲexrʲɪsʲtʲɪ
нивх	nʲifx
нидерландец	nʲɪdʲɪrˈɫ̪änʲdʲɪt͡s
низ	nʲɪˈz̪ɨ
низина	nʲɪˈzʲin̪ə
ник	ˈnʲikʲɪ
никель	ˈnʲikʲɪlʲɪ
никстамализация	nʲɪkstəməlʲɪˈzat͡sɨjə
ним	nʲim
нирвана	nʲɪrˈvän̪ə
нитрат	nʲɪtˈrat
нитрил	nʲɪtˈrʲiɫɨ
нить	ˈnʲitʲɪ
ничтожество	nʲɪˈʨtoʐɨstvə
ничья	nʲɪˈʨji
ништяк	nʲɪʂˈtʲäk
новорождённый	nəvərɐʐˈdʲɵnːɨj
новостройка	nəvɐˈstrojkʲɪ
новояз	n̪əvɐˈjaz̪ɨ
нога	nɐˈga
ноготь	ˈnoɡətʲ
ножны	ˈnoʐnɨnɐˈʐnɨ
нойон	nɐˈjo̞nɨ
ноктюрн	nɐkˈtʲʉrnɨ
ноль	nʌˈlʲi
номинатив	nəmʲɪnɐˈtʲivɨ
нониус	ˈn̪o̞nʲɪʊs̪
норвежец	nɐrˈvʲeʐəts
норвежка	nɐrˈvʲeʐkə
норд	nort
норма	ˈnormə
нормальность	nɐrˈmɑlʲnəsʲtʲ
нормоконтроль	nərməkɐnˈtrolʲ
нос	n̪ɐˈs̪ɨ
носительница	nɐˈsʲitʲɪlʲnʲɪt͡sɨ
носище	n̪əˈsʲiɕːɪ
носорог	nəsɐˈrok
нота	ˈnotə
ноутбук	ˌnoʊtˈbukʲɪ
ночник	nɐʨˈnʲik
ночь	ˈno̞ʨɪ
нощь	noɕː
ноябрь	nəjɪbˈrʲi
нравы	ˈnravɨ
нужник	ˈnuʐnʲɪkʲɪnʊʐnʲɪˈkʲi
нуклеаризация	nʊklʲɪərʲɪˈzɑtsɨjə
нуль	nʊˈlʲi
нычка	ˈnɨt͡ɕkə
ню	nʲʊ
няня	ˈnʲænʲɪ
няшка	ˈnʲaʂkʲɪ
нёбо	ˈnʲɵbə
оазис	ɐˈazʲɪsɨoˈazʲɪsɨ
обалдуй	əbɐɫˈduɪ
обдирала	əbdʲɪˈraɫɨ
обдуманность	ɐbˈdumənːəsʲtʲɪ
обед	ɐˈbʲedɨ
обеднение	əbʲɪd̻ˈnʲenʲɪjə
обедня	ɐˈbʲɛdnʲæ
обезьяна	əbʲɪˈzʲjanɨ̞
обелиск	ɐbʲɪˈlʲisk
обет	ɐˈbʲet
обжа	ɐbˈʐa
обжимка	obʑɨmki
обитель	ɐˈbʲitʲɪlʲ
облак	ˈobləkʲɪ
облако	ˈo̞bɫəkə
облачко	ɐbɫ̪ɐt͡ɕˈka
облачность	obɫəʨnəsʲtʲɪ
облигация	əblʲɪˈgatsɨjə
облик	ˈo̞blʲɪ̝kʲɪ
обложка	ʌbˈloʃkə
облой	ɐˈbɫoi
обломок	ɐbˈɫomək
обморожение	əbmərɐˈʐɛnʲɪjə
обморок	ˈobmərək
обмундирование	əbmʊnʲdʲɪrɐˈvɑnʲɪjə
обмусоливание	əbmʊˈs̪o̞lʲɪvənʲɪə
обновленец	ɐbn̪ɐvˈlʲen̪t͡sɨ
обножь	ˈo̞bn̪əʐɨ
обод	ɐˈbo̞dʲjəˈo̞bəd̪ɨ
обоз	ɐˈbos̪
оболонь	ˈobəɫənʲɪ
оболочка	əbʌˈlo̞ʨkʲɪ
оболтус	ɐˈboɫtʊs
обора	ɐˈbo̞rɨ
оборона	əbɐˈronə
оборотень	ˈobərətnʲɪ
обоснование	əbəsnɐˈvɑnʲɪjə
обработка	ɐbrɐˈbotkə
образ	ˈobrɐzɨ
образец	əbrɐs̪ˈt͡sɨ
образование	ɐbrəz̪ɐˈvänʲɪɪ̯ə
образок	abrazˈkɪ
образчик	ɐbˈraɕːɪk
обрезок	ɐbˈrʲezək
оброк	ɐbˈrokʲɪ
обрусевший	əbrʊˈsʲefʂɨɪ̯
обруч	ˈobrʊʨɪ
обугленный	ɐˈbuɡlʲɪnn̪ɨɪ
обух	ˈobʊxɐˈbux
общага	ɐpˈɕːagə
общежитие	əpɕːɪˈʐɨtʲɪjə
общественность	ɐpˈɕːestvʲɪnːəsʲtʲɪ
общество	ˈo̞pɕɪstvə
общность	ˈopɕnəsʲtʲɪ
объебон	ɐbjɪˈbo̞n̪ɨ
объездчик	ɐbˈjeɕːɪkʲɪ
объект	ɐˈbjekt
объективность	əbjikˈtʲivnəsʲtʲi
обыватель	ɐbɨˈvatʲɪlʲɪ
обыск	ˈo̞bɨs̪k
обычай	ɐˈbɨʨɪɪ̯
овал	ɐˈvaɫɨ
овалогубцы	əˌvɑɫɐˈguptsɨ
овация	ɐˈvatsɨɪ
овен	ɐˈvʲen̪
овердрайв	ˌovʲɪrˈdrajvɨ
оверлок	əvʲɪrˈɫokʲɪ
овоид	ɐˈvoɪdɨ
оволосение	ɐvəlɐˈsʲenʲɪjə
овоскоп	əvɐˈs̪ko̞p
овощ	ˈovəɕːɪ
овсюг	ɐfˈsʲʉk
овцевод	ɐft͡sɨˈvot
овёс	ɐˈvʲɵs
огнищанин	ɐɡnʲɪˈɕːänʲɪ
оголтелость	əgɐɫˈtʲeləsʲtʲɪ
огонь	ɐˈgo̞nʲ
огонёк	əgʌnʲˈkʲi
ограждение	əgrɐʐˈdʲenʲɪjə
огрызок	ɐˈɡrɨzək
огуз	ɐˈɡus
огурец	əgʊˈrʲets
одежда	ɐˈdʲeʐdɨ̞
одеколон	ədʲɪkɐˈɫonɨ
одессит	ɐdʲɪˈsʲːitɨ
одеяло	ədʲɪˈjæɫə
оджибва	ɐˈdʐɨbvə
однополчанин	ədnəpɐɫˈʨænʲɪ
однопроходные	ɐdnəprəxɐˈdnɨɪ
одночлен	ədnɐˈʨlʲenɨ
одобрямс	ɐd̪ɐbˈrʲams̪ɨ
одуванчик	ədʊˈvanʲt͡ɕɪkʲɪ
одушевлённый	ədʊʂɪvˈlʲɵnːɨjə
одёжка	ɐˈdʲɵʂkʲɪ
ожидание	əʐɨˈd̪ɑnʲɪjə
ожог	ʌˈʒo̞k
озеро	ˈozʲɪrə
озон	ɐˈzon
ойкумена	ɐjkʊˈmʲenə
окатышевоз	ɐˌkatɨʂɨˈvo̞z̪ɨ
околичность	əkɐˈlʲit͡ɕnəsʲtʲɪ
оконечность	əkɐˈnʲeʨnəsʲtʲ
окоп	ɐˈkopɨ
окошечко	ɐˈkoʂɨt͡ɕkʲɪ
окрошка	ɐˈkroʂkʲɪ
округление	ɐkrʊɡˈlʲenʲɪɪ̯ə
окружение	əkrʊˈʐenʲɪjɪ
окружность	ɐˈkruʐnəsʲtʲɪ
оксюморон	ɐkˈsʲʉ̞mərən̪ɨ
октоих	ɐkˈtoɪχ
октябрь	əktʲɪbˈrʲi
октябрёнок	ɐktʲɪbˈrʲɵn̪ək
окулист	ɐkʊˈlʲist
окунь	ˈokʊnʲɪ
ол	o̞ɫ
олениха	ɐˈlʲenʲɪxʲɪəlʲɪˈnʲixʲɪ
олень	ɐˈlʲenʲɪ
оленятник	əlʲɪˈnʲæt̻nʲɪkʲɪ
олигарх	əlʲɪˈgarx
олигархша	əlʲɪˈgarxʂɪ
олицетворение	əlʲɪtsətvɐˈrʲenʲɪjə
омофон	ɐmɐˈfonɨ
омуль	ˈomʊlʲ
омуток	ɐmʊˈt̪o̞k
ономатопея	ənəmətɐˈʲejə
опал	ɐˈpaɫ
опала	ɐˈpaɫɨ
опаска	ɐˈpaskə
опахало	əpɐˈxaɫə
опездал	ɐˈpʲez̪d̪əɫ̪ɨ
опен-эйр	ˌopəˈnɛɪ̯r
опер	əpʲɪˈra
оператор	əpʲɪˈratər
операция	əpʲɪˈratsɨjə
описка	ɐˈpʲiskə
оплеуха	əplʲɪˈuxʲɪ
оплодотворение	əpɫədətvɐˈrʲenʲɪjə
оплошность	ʌˈplo̞ʂnəstʲɪ
опоздун	ɐpəz̪d̪ʊˈn̪ɨ
оползень	ˈopəlznʲɪ
ополченец	ɐpɐlˈt͡ɕenʲɪt͡s
опорок	ɐˈporək
опочивальня	əpəʨɪˈvalʲnʲɪ
оппозиционер	ɐpəzʲɪt͡sɨɐˈnʲer
оппонент	əpːɐˈnʲentɨ
оппортунистка	ɐpərtʊˈnʲistkʲɪ
оправка	ɐˈprafkə
опричник	ɐˈprʲit͡ɕnʲɪkʲɪ
опричнина	ɐˈprʲit͡ɕnʲɪnɨ
опровержение	əprəvʲɪrˈʐɛnʲɪjə
опросник	ɐˈpros⁽ʲ⁾nʲɪk
опт	ˈoptɨ
опушка	ɐˈpuʂkʲɪ
опыт	ˈopɨt
оракул	ɐˈrɑkʊɫɨ
орало	ɐˈraɫə
орангутан	ərəngʊˈtan
орбита	ɐrˈbʲitə
оргазм	ɐrˈɡäz̪mɨ
организация	ɐrgənʲɪˈzatsɨ̞ɪ
организм	ərgɐˈnʲizmɨ
органика	ɐrˈganʲɪkʲɪ
оргнабор	ˈorknɐˈbor
оргстекло	ˌorkˈstʲɵkɫə
ординарец	ɐrdʲɪˈnartsɨ
ординатор	ɐrdʲɪˈnatɐrɨ
ордовик	ɐrˈdovʲɪkʲɪ
ореада	ərʲɪˈadɨ
орех	ɐˈrʲex
орешник	ɐˈrʲeʂnʲɪkʲɪ
оригами	ərʲɪˈgamʲɪ
орлица	ɐrˈɫ̪ʲit͡sə
орлянка	ʌrˈlʲankə
орнитолог	ərnʲɪˈtoɫək
орография	ərɐˈgrafʲɪɪ
орфография	ərfɐˈgrafʲɪ
оса	ɐˈsa
осанка	ɐˈsankʲɪ
осахаривание	ɐˈsaxərʲɪvənʲɪɪ̯ə
осведомитель	əsvʲɪdɐˈmʲitʲɪlʲ
освободитель	ɐs̪vəbɐˈdʲitʲɪlʲ
осевок	ɐˈsʲevək
оселедец	ɐsʲɪˈɫ̪ʲed̪t͡sɨ
оселок	əsʲɪɫˈkʲi
осенины	əsʲɪˈnʲinɨ
осень	ˈosʲɪnʲɪ
осетин	əsʲɪˈtʲinɨ
осинка	ɐˈsʲinkə
осколок	ɐsˈkoɫkʲɪ
ослышка	ɐˈslɨʂkʲɪ
османья	ɐsˈmanʲjɪ
осмий	ˈosmʲɪj
основание	ɐsnɐˈvanʲɪjə
основоположник	ɐˌsnovəpɐˈloʐnʲɪkɪ
особист	əsɐˈbʲistɨ
останки	ɐˈstɑnkʲɪ
остановка	əstʌˈno̞fkə
остин	ˈosʲtʲɪnɨ
остойчивость	ɐˈstojt͡ɕɪɪvəsʲtʲ
остракизм	ɐs̪t̪rɐˈkʲiz̪m
остранение	əstrɐˈnʲenʲɪjə
острастка	ɐˈs̪t̪räs̪t̪kɪ
остров	ˈostrəf
острога	əstrɐˈga
осуждённый	ɐs̪ʊʐˈdʲɵn̪ːɨɪ̯
отбелка	ɐd̪ˈbʲeɫ̪kʲɪ
отбивка	ɐdˈbʲifkʲɪ
отброс	ɐdˈbrosɨ
отвага	ɐtˈvaɡʲɪ
отвес	ɐt̪ˈvʲes̪ɨ
ответчик	ɐt̪ˈvʲet͡ɕːɪk
отвёртка	ɐtˈvʲɵrtkə
отдарок	ɐtˈdarək
отдел	ɐtˈdʲeɫ
отель	ɐˈtɛlʲɪ
отжимание	ədʐɨˈmanʲɪjə
отзыв	ɐdˈzɨvɨ
отказ	ɐtˈkazɨ
откат	ɐtˈkatɨ
откачка	ɐtˈkat͡ɕkʲɪ
откол	ɐtˈkolɨ
откос	ɐtˈkos
откровение	ɐt̪krɐˈvʲenʲɪɪ̯ə
отлив	ɐtˈlʲif
отлучение	ətɫʊˈt͡ɕenʲɪjə
отмель	ˈotmʲɪlʲ
относительность	ətnɐˈsʲitʲɪlʲnəsʲtʲɪ
отношение	ətnɐˈʂɛnɪjə
отпевание	ɐtpʲɪˈvanʲɪjə
отповедь	ˈotpəvʲɪdʲɪ
отработка	ətrɐˈbotkʲɪ
отрава	ɐˈtravə
отрасль	ˈotrəslʲɪ
отрезок	ɐtˈrʲezək
отрицатель	ɐtrʲɪˈt͡satʲɪlʲ
отряд	ɐtˈrʲædɨ
отсев	ɐtˈsʲef
отставка	ɐt͡sˈt̪afkə
отставник	ɐtstɐvˈnʲikɪ
отстой	ɐt͡sˈt̪o̞ɪ
оттёк	ɐˈtʲːɵkʲɪ
отуманенный	ɐtumanʲɪnːɨj
отцеубийство	əttsɨʊˈbʲijstvə
отцеубийца	əttsɨʊˈbʲijtsɨ
отчество	ˈoʨɪstvə
отчётность	ɐˈʨːɵtnəsʲtʲ
отшельник	ɐtˈʂelʲnʲɪkʲɪ
отщеп	ɐt͡ɕˈɕːepɨ
отыгрыш	ˈotɨgrɨʂɨ
офицер	əfʲɪˈtsɛrɨ
оффшор	ɐfˈʂor
охломон	əxɫ̪ɐˈmo̞n̪
охота	ɐˈxot̪ɨ
охотник	ɐˈxotnʲɪkɪ
охранка	ɐxˈran̪kʲɪ
охуение	ɐxʊɪ̯jˈenʲɪɪ̯ə
очаг	əʨɪˈgʲi
очажный	əˈʨaʐnɨj
очевидец	ɐt͡ɕɪˈvʲit͡sːɨ
очепятка	ɐt͡ɕɪˈpʲat̪kʲɪ
очередь	ˈot͡ɕɪrʲɪtʲ
очерк	ˈoʨɪrkʲɪ
очертание	əʨɪrˈtanʲɪjə
очечник	ɐˈʨeʂnʲɪkʲɪ
очешник	ɐˈʨeʂnʲɪkʲɪ
очко	ɐʨˈko
ошмёток	ɐˈʂmʲɵtkʲɪ
ощупь	ˈoɕɕʊpʲ
пава	ˈpavɨ
павиан	pəvʲɪˈan
паводок	ˈpavətkʲɪ
пагода	ˈpagədɨ
падаль	ˈpɑdɐlʲ
падеж	pədʲɪˈʐɨ
падекатр	pədɛˈkɑtrɨ
падение	pɐˈdʲenʲɪjə
падик	ˈpadʲɪkʲɪ
падь	ˈpadʲ
паж	pɐˈʐɨ
паз	pɐˈzɨ
пазл	ˈpäz̪ɫ̪ɨ
пайп	ˈpaɪ̯pɨ
пакость	ˈpakəsʲtʲɪ
пал	pɐˈɫɨ
палач	pʌˈlatʃ
палеозой	pəlʲɪɐˈzoɪ
пали	ˈpalʲɪ
палисад	pəlʲɪˈsat
палитра	pɐˈlʲitrɨ
палия	ˈpalʲɪɪ̯ɪ
палка	ˈpɑɫ̪kʲɪ
палладий	pɐˈɫadʲdɪj
паллета	pɐˈlʲetə
палочка	ˈpɑɫət͡ɕkʲɪ
пальма	ˈpalʲmɨ
памфлет	pɐmˈflʲet
память	ˈpämʲɪtʲɪ
панариций	pənɐˈrʲitsɪː
пандемия	pəndɛˈmʲiɪ
панель	pɐˈnɛlʲɪ
пани	ˈpänʲɪ
паника	ˈpanʲɪkə
паникадило	pənʲikʌdʲiɫə
панк-группа	pɐn̪kˈɡrupːə
пансион	pənsʲɪˈon
пантеон	pɐntɜˈon
папа	ˈpɑpə
папарацци	pəpɐˈrattsɨ
папаша	pɐˈpaʂə
папик	ˈpapʲɪk
папироса	pəpʲɪˈrosə
папка	ˈpapkʲɪ
пар	ˈpaɹ
парабола	pɐˈrabəɫə
парадигма	pərɐˈdʲigmɪ
парадиз	pərɐˈdʲizɨ
парадокс	pərɐˈdoks
паразит	pərɐˈzʲit
паралич	pərɐˈlʲiʨ
параплан	pərɐˈpɫan
парафин	pərɐˈfʲin
парашют	pərɐˈɕutɨ
пария	ˈparʲɪɪ
парктроник	pɐrkˈtronʲɪk
парламентарий	pərləmʲɪnˈtarʲɪɪ
парность	ˈparnəsʲtʲ
паровоз	pərɐˈvozɨ
паровозостроение	pərɐˌvozəstrɐˈjenʲɪjə
пародия	pɐˈrodʲɪjɪ
пароль	pɐˈrolʲɪ
паром	pɐˈromɨ
парта	ˈpartə
партизан	pɐrtʲɪˈzan
партикабль	pɐrtʲɪˈkablʲɪ
парус	pərʊˈsa
парусник	ˈparʊs⁽ʲ⁾nʲɪk
паскуда	pɐs̪ˈkud̪ɨ
паспорт	pəspɐrˈtä
пассатижи	pəsɐˈtʲiʐɨ
пассия	ˈpasʲːɪjə
паства	ˈpastvə
пастель	pɐsˈtɛlʲ
пастернак	pəstɛrˈnakʲɪ
пастила	pəsʲtʲɪˈɫa
пастораль	pəstɐˈralʲɪ
пастушок	pɐs̪t̪ʊʂˈkʲi
пасть	ˈpasʲtʲɪ
пасха	ˈpasxə
пасынок	ˈpasɨnkʲɪ
патера	pɐˈtɛrɨ
патология	pət̪ɐˈɫ̪oɡʲɪɪ̯ɪ
патриот	pətrʲɪˈot
патронташ	pətrɐnˈtaʂ
патрулирование	pətrʊˈlʲirəvənʲɪjə
паужин	ˈpäʊʐɨn̪ɨ
пауперизм	paʊpʲɪˈrʲizm
пафос	ˈpafəs
пахан	pəxɐˈnɨ
пахитоса	pəxʲɪˈtosɨ
пахта	ˈpaxtɨ
пацан	pɐˈt͡san̪
паша	pɐˈʂɨ
пащека	ˈpaɕɪkʲɪ
педагог	pʲɪdɐˈgok
педантизм	pʲɪd̪ɐn̪ˈtʲiz̪m
педераст	pʲɪd̪ɛˈräs̪t̪ɨ
педик	ˈpʲedʲɪk
педрила	pʲɪd̪ˈrʲiɫ̪ɨ
педучилище	ˌpʲed̪ʊˈt͡ɕilʲɪɕːə
пейнтбол	pɛɪ̯ndˈbol
пек	ˈpʲɛkʲɪ
пекарня	pʲɪˈkɑrnʲə
пекулий	pʲɪˈkulʲɪɪ
пелена	pʲɪlʲɪˈna
пена	ˈpʲenɨ
пендель	ˈpʲen̪d̪ɛlʲ
пенис	ˈpʲɛnʲɪsˈpʲenis
пенициллин	ˌpenəˈsɪlɪn
пенсне	pʲɪnsˈnɛ
пенька	pʲɪnʲˈka
пенязь	pʲɪˈnʲæzʲɪ
пенёк	pʲɪnʲˈkʲi
пепелац	pʲɪpʲɪˈlats
первачок	pʲɪrvɐʨˈkʲi
первенец	ˈpʲɛrvʲɪnʲɪtsɨ
первенство	ˈpʲeɾvʲɪnstvɐ
перверт	pʲɪrˈvʲert̪ɨ
первоклассник	pʲɪvɐˈkɫɑsʲnʲɪkʲɪ
первооснова	pʲɪrvəɐsˈnovə
пердёж	pʲɪrˈdʲɵʂ
перевитый	pʲɪɾʲɪˈvʲitɨj
переводчик	pʲɪrʲɪˈvoʨɪkʲɪ
перевёртыш	pʲɪrʲɪˈvʲɵrtɨʂɨ
перегной	pʲɪrʲɪˈgnoɪ
передвижной	pʲɪrʲɪdvʲɪʐˈnɨjə
передержка	pʲɪrʲɪˈdʲerʂkə
передник	pʲɪˈrʲedʲnʲɪk
передовик	pʲɪrʲɪdɐˈvʲik
передок	pʲərʲəˈdok
передразнивание	pʲɪrʲˈdrazʲnʲɪvənʲɪjə
переименование	pʲɪrʲɪɪmʲɪnɐˈvanʲɪjə
перелесок	pʲɪrʲɪˈlʲeskʲɪ
перемещение	pʲɪrʲɪmʲɪˈɕːenʲɪjə
перемирие	pʲɪrʲɪˈmʲirʲɪjə
перепевка	pʲɪrʲɪˈpʲefkə
переписка	pʲɪrʲɪˈpʲiskə
переработка	pʲɪrʲɪrɐˈbo̞t̪kʲɪ
пересадка	pʲɪrʲɪˈs̪at̪kə
пересортица	pʲɪrʲɪˈsortʲɪtsɨ
перец	ˈpʲertsɨ
перечень	ˈpʲerʲɪt͡ɕnʲɪ
перешеек	pʲɪrʲɪˈʂɛjkʲɪ
периметр	pʲɪˈrʲimʲɪtr
перл	ˈpʲerɫɨ
перламутр	pʲɪrɫ̪aˈmut̪rɨ
перловка	pʲɪrˈɫofkə
перо	ˈpʲerʲjə
перспектива	pʲɪrs̪pʲɪkˈt̪ʲivə
перстень	ˈpʲersʲtʲɪnʲ
перун	pʲɪˈrun̪ɨ
перфект	pɛrˈfʲekt
перфекционист	pʲɪrfʲɪktsɨɐˈnʲistɨ
перформатив	pʲɪrfərmɐˈtʲif
перчатка	pʲɪrˈt͡ɕätkə
песельник	ˈpʲesʲɪlʲnʲɪk
песенный	ˈpʲesʲɪnːɨj
песнь	pʲesʲnʲɪ
песня	ˈpʲesʲnʲə
песо	ˈpʲes̪ə
песок	pʲɪˈsok
пестик	ˈpʲesʲtʲɪkʲɪ
пестрина	pʲɪs̪t̪rʲɪˈn̪ä
пестринка	pʲɪˈstrʲinkə
пестрота	pʲɪs̪ˈt̪ro̞t̪ɨ
петербуржец	pʲɪtʲɪrˈburʐt͡sɨ
петля	ˈpetlʲɪ
петрушка	pʲɪtˈruʂkə
петун	pʲɪˈtun
петушок	pʲɪtʉˈʂkʲi
пехота	pʲɪˈxotɨ
пехотный	pʲɪˈxotnɨj
печаль	pʲɪˈʨælʲ
печалька	pʲɪˈʨælʲkə
печень	ˈpʲeʨɪnʲɪ
печка	ˈpʲet͡ɕkʲɪ
печь	pʲet͡ɕ
печёнка	pʲɪˈʨonkə
пещера	pʲɪˈɕːerɨ
пещерный	pʲɪˈɕernɨ̞jə
пиала	pʲɪɐˈla
пианино	pʲɪɐˈnʲinə
пивасик	pʲɪˈväsʲɪkʲɪ
пидарас	pʲɪd̪ɐˈras̪
пиджин	ˈpʲidʐɨn
пиджинизация	pʲɪdʐɨnʲɪˈzatsɨjə
пидор	ˈpʲid̪ər
пизда	ˈpʲiz̪d̪ɨ
пиздец	pʲɪzʲˈdʲet͡s
пиздобол	pʲɪz̪d̪ɐˈbo̞ɫ̪
пиздорванка	pʲɪz̪d̪ɐˈrvan̪kʲɪ
пиздоремонтник	pɪz̪d̪ərʲɪˈmo̞n̪t̪nʲɪk
пиздос	pʲɪz̪ˈd̪o̞s̪ɨ
пиздун	pʲɪz̪ˈd̪un̪
пиздюль	pʲɪzʲˈdʲʉ̞lʲ
пиздюшка	pʲɪzʲˈdʲʉ̞ʂkʲɪ
пиздёныш	pʲɪzʲˈdʲɵn̪ɨʂ
пиит	pʲɪˈit̪ɨ
пиита	pʲɪˈitə
пика	ˈpʲikə
пики	ˈpʲikʲɪ
пиковка	pʲɪˈkofkə
пилигрим	pʲɪlʲɪˈgrʲimɨ
пилка	ˈpʲiɫkʲɪ
пилон	pʲɪˈlo̞n
пилум	ˈpʲiɫʊmɨ
пиндос	pʲɪnˈdos
пино-нуар	pʲɪˈnonʊˈar
пиноль	pʲɪˈnolʲɪ
пиноцитоз	pʲɪnət͡sɨˈtozɨ
пион	pʲɪˈo̞nɨ̞
пионерка	pʲɪɐˈnʲerkə
пипец	pʲɪˈpʲets
пиписька	pʲɪˈpʲisʲkə
пирамида	pʲɪrɐˈmʲidə
пират	pʲɪˈratɨ
пиратство	pʲɪˈratstvə
пироман	pʲɪrɐˈmanɨ
писака	pʲɪˈsakə
писанка	ˈpʲisɐnkɪ
писаный	ˈpʲisənɨjə
писатель	pʲiˈsatʲɪlʲ
писательница	pʲɪˈsatʲɪlʲnʲɪt͡sə
писк	ˈpʲiskʲɪ
пистолет	pʲɪstɐˈlʲet
письмо	pʲɪsʲˈmo
пися	ˈpʲisʲɪ
питкэрнец	ˈpʲitkərnʲet͡s
питкэрнка	ˈpʲitkərnkʲɪ
питьё	pʲɪˈtʲjo̞
пицца	ˈpʲitsə
пичужка	pʲɪˈʨuʂkə
пища	ˈpʲiɕːə
пищаль	pʲɪˈɕːælʲɪ
пищевод	pʲɪɕːɪˈvot
плаватель	ˈpɫavətʲɪlʲ
плагиат	pɫəgʲɪˈɑtɨ
плагин	plɐˈɡʲin
плазмодий	plɐzˈmodʲɪɪ
плакальщик	ˈpɫakəlʲɕːɪk
пламя	ˈpɫamʲə
планер	ˈpɫanʲɪrɨ
планетолёт	plənʲɪtɐˈlʲɵt
планетоход	plənʲɪtɐˈxodɨ
пластилин	pɫəsʲtʲɪˈlʲinɨ
пластун	pɫɐstʊˈnɨ
пластырь	ˈpɫastɨɨrʲ
платан	pɫɐˈtanɨ
платье	ˈpɫɑtʲjə
плаха	ˈpɫaxə
плахта	ˈpɫ̪axt̪ə
плацента	plɐˈt͡sɛntɨ
плашка	ˈpɫaʂkʲɪ
плебей	plʲɪˈbʲeɪ
плевок	plʲɪˈvok
плей-лист	pɫəɪ̯ˈɫʲist
плексиглас	plʲɪksʲɪˈɡɫas
племя	plʲɪmʲɪˈna
племянница	plʲɪˈmʲænʲːɪtsɨ
плесень	ˈplʲesʲɪnʲ
плеск	ˈplʲeskʲɪ
плетение	plʲɪˈtʲenʲɪjə
плетюган	plʲɪtʲʊˈgan
плечо	plʲɪˈt͡ɕo
плита	plʲɪˈta
плитка	ˈplʲitkʲɪ
плица	ˈplʲit͡sɨ
плов	pɫof
плод	pɫot
плодотворный	pɫədɐˈtvornɨjə
плоскогорье	pɫəskɐˈgo̞rʲjə
плоскогубцы	pləskɐˈguptsɨ
плоскость	ˈpɫoskəsʲtʲ
плот	pɫot
плотник	ˈpɫot⁽ʲ⁾nʲɪkʲɪ
плотничание	ˈpɫ̪o̞t̪nʲɪt͡ɕɪnʲjə
плотничанье	ˈpɫ̪o̞t̪nʲɪt͡ɕənʲə
плотовщик	pɫ̪ət̪ɐfɕːɪˈkʲi
плоть	ˈpɫotʲɪ
площадь	ˈpɫoɕːɪdʲɪ
плуг	ˈpɫuɡʲɪ
плут	pɫʊˈtɨˈpɫutɨ
плюсквамперфект	plʲʉskvəmpɛrˈfʲektɨ
пляж	ˈplʲaʐɨ
плётка	plʲɵtkʲɪ
победа	pɐˈbʲedɨ
поборник	pɐˈbo̞rnʲɪk
побрякушка	pəbrʲɪˈkuʂkə
повадка	pɐˈvɑtkə
повар	ˈpovər
поварёнок	pəvɐˈrʲɵnək
поведенция	pəvʲɪˈdʲen̪t͡sɨɪ
повелитель	pɐvʲɪˈlʲitʲɪlʲ
поверка	pɐˈvʲerkʲɪ
поверье	pɐˈvʲerʲjə
повесть	ˈpovʲɪsʲtʲɪ
повешенный	pɐˈvʲeʂɪnɨj
повитуха	pəvʲɪˈtuxə
повозочный	pɐˈvozət͡ɕnɨɪ
повышение	pəvɨ̞ˈʂenʲɪ̝jə
погадка	pɐˈgatkʲɪ
поганка	pɐˈgankə
поговорка	pəgɐˈvo̞rkə
погода	pɐˈɡodɨ
погонофора	pəɡənɐˈforə
погонщик	pɐˈgonʲɕɕɪk
пограничник	pəgrɐˈnʲit͡ɕnʲɪk
погремушка	pəgrʲɪˈmuʂkʲɪ
погром	pɐˈgromɨ
подавитель	pədɐˈvʲitʲɪlʲ
подарок	pɐˈdɑrək
подберёзовик	pɐd̪bʲɪˈrʲɵz̪əvʲɪk
подбородок	pədbɐˈrodək
подвиг	ˈpodvʲɪk
подвижник	pɐˈdvʲiʐnʲɪk
подгузник	pɐdguznʲɪkʲɪ
поддевание	pədʲːɪˈvanʲɪjə
поддержка	pɐˈdʲːerʂkə
поддув	pɐˈdːuf
поддувало	pəd̪ːʊˈväɫ̪ə
поделка	pɐˈdʲeɫkə
подельник	pɐˈdʲelʲnʲɪk
поджаренный	pɐdˈʐarʲɪnːɨjɪ
поджопник	pɐd̪ˈʐo̞pnʲɪkʲɪ
подземка	pɐdˈzʲemkʲɪ
подкидыш	pɐtˈkʲidɨʂ
подкладка	pətˈkɫatkʲɪ
подключение	pətklʲʉˈʨenʲɪjə
подледник	pɐdˈlʲed⁽ʲ⁾nʲɪk
подлежащее	pədlʲɪˈʐaɕːəjə
подлец	pɐdˈlʲet͡s
подмастерье	pədmɐsʲˈtʲerʲjə
подмышка	pɐdˈmɨʂkə
подначка	pɐdˈnaʨkə
подножка	pɐd̻ˈnoʂkʲɪ
подогрев	pɐdɐˈgrʲevɨ
подонок	pɐˈdonək
подопечный	pədɐˈpʲeʨnɨj
подорожная	pədɐˈroʐnɨjə
подорожник	pədɐˈroʐnʲɪkʲɪ
подпасок	pɐtˈpaskʲɪ
подпевала	pətpʲɪˈvalə
подполковник	pətpɐɫˈkovnʲɪkʲɪ
подпоручик	pɐdpɐˈɾutɕɪk
подработка	pədrɐˈbotkə
подразделение	pədrəzdʲɪˈlʲenʲɪjə
подросток	pɐdˈrostkʲɪ
подруга	pɐˈdrugʲɪ
подручный	pɐdˈruʨnɨj
подряд	pɐdˈrʲät̪
подрядчик	pɐdˈrʲæʨːɪk
подсека	pɐtˈsʲekʲɪ
подсечка	pɐtˈsʲeʨkə
подснежник	pɐtʲˈsʲnʲeʐnʲɪkʲɪ
подсолнух	pɐt̪ˈs̪o̞ɫ̪n̪ʊx
подсрачник	pɐt̪ˈs̪rɑt͡ɕnʲɪkʲɪ
подстава	pɐt͡sˈtavə
подстилка	pɐtˈstʲiɫkʲɪ
подступенок	pɐt̪s̪t̪ʊˈpʲen̪ək
подтверждение	pətvʲɪrˈʐdʲenʲɪjə
подтекст	pɐˈtʲːeks̪t̪ɨ
подхалимство	pətxɐˈlʲimstvə
подчинённый	pət͡ɕɪˈnʲɵnːɨjɪ
подшива	pɐt̪ˈʂɨvə
подьячий	pɐˈdʲjæt͡ɕɪɪ̯
поединок	pəjɪˈdʲinkʲɪ
поезд	ˈpoɪs̪t̪
поездка	pɐˈjestkə
пожар	pɐˈʐarɨ
пожарка	pɐˈʐarkʲɪ
пожарный	pɐˈʐarnɨj
пожертвование	pɐˈʐɛrtvəvənʲɪjə
позвонок	pəzvɐnˈkʲi
позитрон	pəzʲɪˈtron
позиция	pɐˈzʲit͡sɨɪ
позор	pɐˈz̪o̞rɨ
позёмка	pɐˈzʲɵmkʲɪ
позёр	pɐˈzʲɵr
поиск	ˈpoɪskʲɪ
покемон	pəkʲɪˈmon
поклонник	pɐˈkɫ̪o̞nːɪkʲɪ
поклонница	pɐˈkɫ̪o̞nːɪt͡sɨ
покои	pɐˈkoɪ
покойник	pɐˈkoɪ̯nʲɪkʲɪ
покойница	pɐˈkojnʲɪtsɨ
покойницкая	pɐˈkojnʲɪtskəjə
покорение	pəkəˈrʲenʲɪjə
покрытие	pʌˈkrɨtʲɪjə
покрышка	pɐˈkrɨʂkʲɪ
покупка	pɐˈkupkʲɪ
пол	ˈpo̞ɫ̪ɨ
полба	ˈpoɫbɨ
поле	pɐˈlʲä
полемика	pɐˈlʲemʲɪkʲɪ
ползун	pəɫzʊˈnɨ
полив	pɐˈlʲivɨ
полиглот	pəlʲɪˈglot
полином	pəlʲɪˈnom
политбюро	pəlʲɪt̻bʲʉˈro
политик	pɐˈlʲitʲɪk
политика	pəˈlʲitʲɪkə
политинформатор	pɐˌlʲitɨnfɐrˈmatərɨ
политрук	pəlʲɪtˈruk
полицейский	pəlʲɪˈtsɛjskʲɪj
полиция	pɐˈlʲitsɨɪ
полк	poɫk
полковник	pɐɫˈkovnʲɪk
полководец	pəɫkɐˈvodʲɪt͡s
поллюция	pəˈlʲʉtsɨɪ
половинка	pəɫɐˈvʲinkʲɪ
полоний	pɐˈɫonʲɪj
полость	ˈpoɫ̪əsʲtʲ
полотнище	pɐˈɫ̪o̞tnʲɪɕə
полотно	pɐˈɫotnə
полсть	ˈpols⁽ʲ⁾tʲ
полтинник	pɐɫ̪ˈtʲinʲːɪkʲɪ
полугар	pəɫʊˈgar
полуденница	pɐˈɫudʲɪnʲːɪt͡sɨ
полуостров	pəɫʊəstrɐˈva
полураспад	pəɫʊrɐsˈpat
полусорочины	poɫʊsɐrɐˈtɕinɨ
полусферический	pəɫʊsfʲɪˈrʲiʨɪskʲɪjə
полутон	pəɫʊˈton
полуфуганок	pəɫʊfʊˈganək
полушубок	pəɫ̪ʊˈʂubkʲɪ
полуязычие	pəɫʊɪˈzɨt͡ɕɪ̯ə
полюс	ˈpolʲʉsɨpəlʲʉˈsa
поляк	pɐˈlʲakʲɪ
полячка	pɐˈlʲæt͡ɕkʲɪ
полёвка	pɐˈlʲɵfkʲɪ
полёт	pʌˈlʲo̞t
помазок	pəmɐsˈkʲi
померанец	pɐmʲɪˈran̪t͡sɨ
поместье	pɐˈmʲesʲtʲɪj
помидор	pəmʲɪˈdor
помин	pɐˈmʲinɨ
поминки	pɐˈmʲinkʲɪ
помол	pɐˈmol
помочь	ˈpo̞mət͡ɕ
помощь	ˈpo̞məɕː
помпа	ˈpompɨ
помёт	pɐmʲɵt
понедельник	pənʲɪˈdʲelʲnʲɪkʲɪ
пони	ˈponʲɪ
понимание	pɐnʲɪˈmanʲɪjə
поножи	ˈpo̞n̪əʐɨpɐˈn̪o̞ʐɨ
поножовщина	pɐnɐˈʐo̞fɕɕɪnə
пономарь	pən̪ɐˈmärʲ
понтярщик	pɐn̪ˈt̪ʲarɕɪk
понёва	pɐˈnʲo̞vɨ
попаданец	pəpɐˈdant͡sɨ
попадья	pəpɐˈdʲjæ
попевка	pɐˈpʲefkʲɪ
попка	ˈpopkə
поплавок	pəpɫɐfˈkʲi
поплин	pɐˈplʲinɨ
поползень	ˈpopəɫznʲɪ
пополнение	pəpɐɫˈnʲenʲɪjə
попрыгунья	pəprɨˈgunʲjɪ
попса	pɐpˈsa
попугай	pəpuˈɡäɪ̯
популист	pəpʊˈlʲistɨ
попутка	pɐˈputkʲɪ
поранение	pərɐˈnʲenʲɪjə
поребрик	pɐˈrʲebrʲɪkʲɪ
порез	pɐˈrʲes
порнография	pərnɐˈgrafʲɪjə
порождение	pərɐʐˈdʲenʲɪjə
порох	ˈporəx
пороховница	pərəxɐvˈnʲit͡sɨ
порошок	pərɐˈʂkʲi
портал	pʌrˈtaɫɨ
портвейн	pɐrtˈvʲejnɨ
портняжка	pɐrtˈnʲaʂkə
портрет	pɐrtˈrʲetɨ
портупея	pərtʊˈpʲejɪ
портье	pɐrˈtʲje
портянка	pɐrˈtʲænkə
порука	pɐˈrukə
поручень	ˈporʊʨnʲɪ
поручик	pɐˈruʨɪk
поручица	pɐˈrutɕɪtsɐ
порфира	pɐrˈfʲirɨ
порядок	pɐˈrʲædək
порядочек	pɐˈrʲædəʨək
посев	pɐˈsʲevɨ
поселянин	pəsʲɪˈlʲænʲɪn
поселянка	pəsʲɪˈlʲankə
последователь	pɐˈs⁽ʲ⁾lʲedəvətʲɪlʲ
последовательность	pɐˈslʲedəvətʲɪlʲnəsʲtʲ
пословица	pɐˈsɫovʲɪtsə
пост	ˈpost
постамент	pəs̪t̪ɐˈmʲen̪t̪ɨ
постаментик	pəs̪t̪ɐˈmʲenʲtʲɪk
постаментище	pəs̪t̪ɐˈmʲenʲtʲɪɕːə
постановление	pəstənɐvˈlʲenʲɪjə
постобработка	pəstəbrɐˈbotkə
постовой	pəstɐˈvoj
пострижение	pəs̪t̪rʲɪˈʐɛnʲɪɪ̯ə
посудка	pɐˈsutkʲɪ
посыльный	pɐˈsɨlʲnɨjɪ
посягательство	pəsʲɪˈgatʲɪlʲstvə
посёлок	pɐˈsʲɵɫək
потаканция	pət̪ɐˈkan̪t͡sɨjə
потаскушка	pətɐsˈkuʂkʲɪ
потеря	pɐˈtʲerʲɪ
потеряшка	pətʲɪˈrʲaʂkə
потеха	pɐˈtʲɛxɪ
потир	pɐˈtʲir
потлач	ˈpot͡ɫət͡ɕɪ
потолок	pət̪ɐˈɫ̪o̞k
потомок	pɐˈtomkʲɪ
потомство	pɐˈtomstvə
потягушечки	incorrect
пофигизм	pəfʲɪˈɡʲizmɨ
похабник	pɐˈxabnʲɪk
похмелье	pʌˈxmʲelʲjə
поход	pɐˈxodɨ
похолодание	pəxəɫɐˈdɑnʲɪjə
похуизм	pəxʊɪ̯ˈiz̪m
поц	pot͡s
початок	pɐˈʨætkʲɪ
почерк	ˈpot͡ɕɪrk
почести	ˈpo̞t͡ɕɪs̪tʲɪ
почитатель	pət͡ɕɪˈt̪atʲɪlʲ
почка	ˈpoʨkə
почтамт	pɐˈtʃtamt
почёт	pɐˈʨɵt
пошляк	pɐʂlʲɪˈkʲi
пощада	pɐˈɕædə
пощёчина	pɐˈɕːɵt͡ɕɪnə
поэзия	pɐˈɛzʲɪɪ
поэт	pɐˈɛtɨ
поэтесса	pəɨˈtɛsːə
пояс	pəjɪˈsa
правдивейший	prɐv́divʲɪjʂɪjɛ
правдоискатель	ˌprɐvdəɪsˈkatʲɪlʲ
православие	prəvɐˈslavʲɪjə
православный	prəvɐˈsɫavnɨjə
прадедушка	prɐˈdʲedʊʂkə
праздник	ˈprazʲnʲɪkʲɪ
празднование	ˈprazdnəvənʲɪjə
практик	ˈpraktʲɪkʲɪ
практикабль	prəktʲɪˈkäblʲɪ
праматерь	prɐˈmatʲɪrʲɪ
праотец	prəɐˈtʲet͡s
прапор	ˈprapər
прапорщик	ˈprapərɕːɪkʲɪ
прачка	ˈpraʨkʲɪ
пращур	ˈpraɕɕʊr
праязык	prajɪˈzɨk
превалирование	prʲɪvɐˈlʲirəvənʲɪjə
предвестие	prʲɪd̪ˈvʲesʲtʲɪɪ̯ə
предвкушение	prʲɪt̪fkʊˈʂɛnʲɪjə
преддверие	prʲɪdːˈvʲerʲɪjə
предел	prʲɪˈdʲeɫɨ
предикативный	prʲɪdʲɪkɐˈtʲivnɨjə
предмет	prʲɪdˈmʲetɨ
предобработка	prʲɪdəbrɐˈbotkʲɪ
предостережение	prʲɪdəsʲtʲɪrʲɪˈʐɛnʲɪjə
предписьменность	prʲetˈpʲisʲmʲɪnəsʲtʲɪ
предпосылка	prɪtpɐˈsɨlka
предприниматель	prʲɪtprʲɪnʲɪˈmatʲɪlʲ
предрассудок	prʲɪdrɐˈsːudək
представитель	prʲɪtstɐˈvʲitʲɪlʲ
предтеча	prʲɪˈtʲːeʨɪ
предъява	prʲɪˈdjavə
предыстория	prʲɪdɨsˈtorʲɪjə
презенс	ˈprɛzɨnsɨ
презерватив	prʲɪzʲɪrvɐˈtʲivɨ
презрительный	prʲɪˈzrʲitʲɪlʲnɨj
прелесть	ˈprʲelʲɪsʲtʲ
пренебрежительный	prʲɪnʲɪbrʲɪˈʐɨtʲɪlʲnɨjə
преобладание	prʲɪəbɫɐˈdanʲɪjə
препод	ˈprʲɛpɐdɨ
преподавание	prʲɪpədɐˈvanʲɪjə
прессинг	ˈprʲesʲɪn̻k
пресуппозиция	prʲɪsʊpɐˈzʲit͡sɨjə
претерит	prɨˈtɛrʲɪt
преувеличение	prʲɪʊvʲɪlʲɪˈt͡ɕenʲɪjə
преувеличивание	prʲɪʊvʲɪˈlʲit͡ɕɪvənʲɪjə
преуспеяние	prʲɪʊs̪pʲɪɪ̯ˈænʲɪɪ̯ə
префикс	prʲefʲɪks̪ɨ
прещенье	prʲɪˈɕːɛnʲjɛ
прибавление	prʲɪbɐvˈlʲenʲɪjə
приблуда	prʲɪˈbɫ̪ud̪ə
привет	prʲɪˈvʲet
приветствие	prʲɪˈvʲet͡st̪vʲɪɪ̯ə
привилегированный	prʲɪvʲɪlʲɪgʲɪˈrovənɨjɪ
привлекательность	prʲɪvlʲɪˈkatʲəlʲnəsʲtʲ
привой	prʲɪˈvoɪ̯
приволье	prʲɪˈvolʲjə
пригород	ˈprʲigərət̪
пригоршня	ˈprʲigərʂnʲɪprʲɪˈgorʂnʲɪ
придаток	prʲɪˈdatkʲɪ
приезжающий	prʲɪɪ̯ɪˈʑːæɪ̯uɕːɪɪ̯ɪ̈
приезжий	prʲɪˈjeʑːɪjə
призвание	prɪˈzvanʲɪjɘ
призвук	ˈprʲiz̪vʊkʲɪ
приземистый	prʲɪˈzʲemʲɪstɨj
признание	prʲɪˈznanʲɪjə
призрак	ˈprizrəkʲɪ
приказчик	prʲɪˈkaɕːɪkʲɪ
приклад	prʲɪˈkɫɑt
приключение	prʲɪklʲʊˈt͡ɕenʲɪɪ̯ə
приложение	prʲɪɫɐˈʐɛnʲɪjə
примат	prʲɪˈmat
примета	prʲɪˈmʲet̪ɨ
примирение	prʲɪmʲɪˈrʲenʲɪjə
примула	ˈprʲimʊɫɨ
принт	prʲɪnˈtɨ
принуждение	prʲɪnʊʐˈdʲenʲɪjə
принц	ˈprʲnt͡s
принципал	prʲɪnt͡sɨpaɫɨ
припев	prʲɪˈpʲef
припертень	ˈprʲipʲɪrt̪nʲɪ
природный	prʲɪˈrod̪n̪ɨɪ
приспособление	prʲɪspəsɐbˈlʲenʲɪjə
приставка	prʲɪˈstafkʲɪ
притвора	prʲɪˈtvorɨ
притворство	prʲɪˈtvorstvə
притупленность	prʲɪˈt̪uplʲɪn̪ːəsʲtʲɪ
притча	ˈprʲit̪t͡ɕɪ
приход	prʲɪˈxodɨ
прицел	prʲɪˈtsɛɫ
причастие	prʲɪˈʨæsʲtʲɪjə
причина	prʲɪˈt͡ɕinɨ
причудливость	prʲɪˈʨʉdlʲɪvəsʲtʲɪ
причёска	prʲɪˈʨɵskʲɪ
пришелец	prʲɪˈʂɛlʲtsɨ
пришлец	prʲɪˈʂlʲɛts
приятель	prʲɪˈjætʲɪlʲ
проведение	prəvʲɪˈdʲenʲɪjə
провод	ˈprovət
провожающий	prɐvɐˈʐaɪ̯uɕːɪɪ̯
провокатор	prəvɐˈkɑtərɨ
прога	ˈprogʲɪ
прогалина	prʌˈgalinə
прогноз	prɐˈgnozɨ
программа	prɐˈgramːɨ
программист	prəgrɐˈmʲistɨ
прогресс	prɐˈgrɛsɨ
продажа	prɐˈdaʐə
продажник	prɐˈdaʐnʲɪk
продовольствие	prəd̪ɐˈvo̞lʲs̪t̪vʲɪɪ̯ə
продюсер	prɐˈdʲʉsər
проектирование	prəjɪkˈtʲirəvənʲɪjə
прожектор	prəˈʐɨktɐˈraprɐˈʐɛktərɨ
прожектёр	prəʐɨkˈtʲɵrɨ
прожилка	prɐˈʐɨɫkə
прожорливый	prɐˈʐorlʲɪvɨjə
прозаик	prɐˈzaɪkʲɪ
прозак	ˈproz̪əkʲɪ
прозвище	ˈprozvʲɪɕːə
проигрыш	ˈproɪgrɨʂɨ
произведение	prəɪzvʲɪˈdʲenʲɪjə
производительность	prəɪzvɐˈdʲitʲɪlʲnəsʲtʲɪ
произношение	prəɪznɐˈʂɛnʲɪjə
прокладка	prɐˈkɫatkə
проклятие	prɐˈklʲætʲɪjə
прокурор	prəkʊˈrorɨ
пролетарий	prəlʲɪˈtarʲɪj
пролив	prɐˈlʲivɨ
пролёт	prɐˈlʲɵt
пролётка	prɐlʲo̞tkɐ
промасленный	prɐˈmas⁽ʲ⁾lʲɪnːɨj
промежность	pɾɐˈmʲɛʐnɐstʲ
промежуток	prəmʲɪˈʐutkʲɪ
променад	prəmʲɪˈnat
промышленный	prɐˈmɨʂlʲɪnɨjə
проницательность	prənʲɪˈtsatʲɪlʲnəsʲtʲ
прообраз	pɾɐˈobɾəzᵻ
пропаганда	prəpɐˈɡän̪d̪ɨ
пропагандон	prəpəgɐnˈd̪o̞n̪ɨ
пропасть	ˈpropəsʲtʲ
пропеллер	prɐˈpʲelʲːɪr
проповеднический	prəpɐˈvʲed⁽ʲ⁾nʲɪt͡ɕɪskʲɪj
проповедь	ˈpropəvʲitʲ
пропуск	prəpʊsˈka
проран	prɐˈran
прорванный	ˈprorvɐnnɨj
пророк	prɐˈrok
просак	prɐˈs̪ak
просмотр	prɐˈs̪mo̞t̪r
простак	prəstɐˈkʲi
проститут	prəsʲtʲɪˈt̪ut̪
проститутка	prəsʲtʲɪˈtutkʲɪ
простокваша	prəstɐkˈvaʂɪ
простолюдин	prəstəlʲʉˈdʲin
простота	prɐs̪t̪ɐˈt̪a
пространство	prɐˈstranstvə
простыня	ˈprostɨnʲɪ
просыпание	prəsɨˈpɑnʲɪjə
проталина	prɐˈtalʲɪnɨ
протекторат	prətʲɪktɐˈrat
протест	prʌˈtʲɛstɨ
противопоставление	prətʲɪvəpəstɐˈvlʲenʲɪjə
протологизм	prət̪əɫ̪ɐˈgʲiz̪m
протон	prɐˈtonɨ
протоплазма	prətɐˈpɫazmɨ
протрезвление	prətrʲɪzvˈlʲenʲɪjə
протяжённость	prtʲɪˈʐonːəsʲtʲɪ
профан	prɐˈfan
профанация	prəfɐˈn̪ät͡sɨɪ
профессиональный	prəfʲɪsʲɪɐˈnalʲnɨjə
профессия	prɐˈfʲesʲːɪː
профессор	prəfʲɪsːɐˈraprɐˈfʲesːərɨ
профессура	prəfʲɪˈsːurə
профитроль	prəfɪtˈrolʲ
проход	prɐˈxodɨ
проходимец	prəxɐˈdʲimt͡sɨ
процессор	prɐˈtsɛsərɨ
прошмандовка	prəʂmɐn̪ˈd̪o̞fkʲɪ
прощанье	prɐˈɕːänʲjə
проёбчик	prɐˈjɵpt͡ɕɪkʲɪ
проёбщик	prɐˈjɵpɕːɪkʲɪ
пруд	prʊˈdɨ
прут	ˈprutʲjəprʊˈtɨ
пруф	ˈprufɨ
прыгучесть	prɨˈgut͡ɕɪs̪ʲt̪ʲ
прыжок	prɨʂˈkʲi
прядь	pɾʲædʲ
пряность	ˈprʲænəsʲtʲ
прятки	ˈprʲætkʲɪ
псаломщик	psɐˈɫomɕːɪkʲɪ
псалтирь	psɐɫˈtiɾʲɪ
псалтырь	psɐɫˈtɨɾʲɪ
псальмопевец	psəlʲmɐˈpʲeft͡sɨ
псевдодальность	ˌpsʲevdɐˈdalʲnəsʲtʲ
псевдорусский	ˌpsʲevd̪əˈruskʲɪj
псина	ˈpsʲinə
псих	ˈpsʲixʲɪ
психиатор	psʲɪxʲɪˈatər
птах	ˈptaxʲɪ
птица	ˈpt̪ʲit͡sə
птица-носорог	ˈptʲit͡sɨn̪əs̪ɐˈro̞ɡʲɪ
птичка	ˈptʲiʨkə
публицист	publıˈtsist
пугач	pʊgɐˈʨi
пуговка	ˈpugəfkə
пузико	ˈpuzʲɪkʲɪ
пузо	ˈpuz̪ə
пузырчатка	pʊzɨrˈʨætkə
пукан	pʊˈkän̪
пульс	ˈpulʲsɨ̞
пуля	ˈpulʲə
пунсон	pʊnˈson
пупок	pʊpˈkʲi
пупс	pupsɨ
пурга	pʊrˈga
пустота	pʊsˈtotɨ
пустыня	pʊsˈtɨnʲə
путч	put͡ɕ
путчист	pʊˈʨːist
путь	pʊˈtʲi
пуховик	pʊxəvʲɪˈkʲi
пуховка	pʊˈxofkə
пушка	ˈpuʂkə
пушкинистика	pʊʂkɪˈnʲistʲɪk
пушкиноведение	pʊʂkʲɪnəˈvʲedʲɪnʲɪje
пфенниг	ˈpfʲenʲːɪgʲɪ
пчак	ˈpt͡ɕak
пчела	pʨˈlʲɵɫɨ
пчелоед	pt͡ɕɪɫɐˈjet
пшеница	pʂɨˈnʲitsə
пыльник	ˈpɨlʲnʲɪk
пырей	pɨˈrʲeɪ
пытка	ˈpɨtkʲɪ
пышный	ˈpɨʂnɨjɪ
пьянство	ˈpʲjænstvə
пэр	pɛr
пядь	pʲætʲ
пясть	ˈpʲæsʲtʲɪ
пятак	pʲɪtɐˈkʲi
пятачок	pʲɪt̪ɐt͡ɕˈkʲi
пятигранник	pʲɪtʲɪˈgranʲnʲɪk
пятидесятник	pʲɪtʲɪdʲɪˈsʲætnʲɪkʲɪ
пятка	ˈpʲætkʲɪ
пятнистый	pʲɪtˈnʲistɨj
пятница	ˈpʲætʲnʲɪtsə
пёс	pʲɵs
раб	rɐˈbɨ
раба	rɐˈbɨ
рабовладение	rəbəvɫɐˈdʲenʲɪjə
работа	rɐˈbo̞tɨ
работник	rɐˈbotnʲɪk
работорговля	rəbətɐrˈgovlʲə
рабство	ˈrapstvə
равнение	rɐvˈnʲenʲɪjə
равновесие	rəvnɐˈvʲesʲɪjə
равномерность	rəvnɐˈmʲernəsʲtʲɪ
рагу	rɐˈgu
рада	ˈradə
радий	ˈradʲɪɪ
радикал	rədʲɪˈkaɫ
радиксоид	rədʲɪkˈs̪oit̪
радиоактивность	rədʲɪəɐkˈtʲivnəsʲtʲɪ
радиометрия	ˌradʲɪɐˈmʲetrʲɪː
радиопередатчик	ˌrädʲɪəopʲɪrʲɪˈd̪ät̪t͡ɕɪk
радиопромышленность	rədʲɪəprɐˈmɨʂlʲɪnːəsʲtʲ
радон	rɐˈdonɨ
радуга	ˈradʊgʲɪ
радужник	ˈradʊʐnʲɪkʲɪ
разбег	rɐzˈbʲek
разбойник	rɐzˈbojnʲɪk
разбойный	rɐzˈbojnɨj
разбор	rɐzˈbo̞rɨ̞
разброд	rɐz̪ˈbro̞d̪ɨ
разбрызгиватель	rɐzˈbrɨzgʲɪvətʲɪlʲɪ
развал	rɐzˈvaɫɨ
разветвление	rəz̪vʲɪt̪vˈlʲenʲɪɪ̯ə
развлечение	rəzvlʲɪˈʨenʲɪjə
разврат	rɐz̪vˈrät̪
развёртка	rɐzˈvʲɵrtkʲɪ
разгибание	rəzgʲɪˈbanʲɪjə
разглагольствование	rəzgɫɐˈgolʲstvəvənʲɪjə
разгон	rɐzˈgonɨ
разгром	rɐzˈgromɨ
разгрузчик	rɐzˈgruɕːɪkʲɪ
раздача	rɐzˈdaʨɪ
раздвой	rɐzˈdvoj
раздел	rɐzʲˈdʲeɫ
разделение	rəzʲdʲɪˈlʲenʲɪjə
раздолбай	rəzdɐɫˈbaɪ
раздолье	rɐzˈdolʲjə
раздумье	rɐzˈdumʲjə
разжигание	rəzʐɨˈganʲɪjərəʐːɨˈganʲɪjə
разик	ˈrazʲɪk
размежевание	rəzmʲɪʐɨˈvanʲɪjə
размер	rɐzˈmʲerɨ
разница	ˈrazʲnʲɪt͡sə
разность	ˈrɑznəsʲtʲ
разноцветье	rəznɐˈtsvʲetʲjə
разрез	rɐzˈrʲezɨ
разрешение	rəzrʲɪˈʂɛnʲɪjə
разруха	rɐz̪ˈruxə
разрядник	rɐz̪ˈrʲad̪nʲɪk
разум	ˈrazʊm
разъебай	rəz̪ɪ̯jɪˈbaɪ̯j
райдер	ˈraɪ̯d̪ərɨ
райжилотдел	rəjʐɨlɐˈdʲelɨ
районирование	rəjɐˈnʲirəvənʲɪjə
райцентр	rɐjˈtsɛntrɨ
рак	rakʲɪ
рак-отшельник	ˈräkɐt̪ˈʂelʲnʲɪk
рака	ˈrakɪ
ракета	rɐˈkʲetɨ
ракетка	rɐˈkʲetkʲɪ
ракетовоз	rɐˌkʲetɐˈvo̞z̪ɨ
раковина	ˈrakəvʲɪnɨ
ракушка	rɐˈkuʂkə
рало	ˈraɫə
рама	ˈramə
рамень	ˈrämʲɪnʲ
рамолик	rɐˈmolʲɪkʲɪ
рамэн	rɐˈmɛn
ранитомия	rənʲɪˈto̞mʲɪɪ
ранка	ˈrankə
рапира	rɐˈpʲirə
раскрепощённость	rəskrʲɪpɐˈɕːɵnːəsʲtʲ
распевка	rɐˈspʲefkʲɪ
распиздяй	rəs̪pʲɪzʲˈdʲæɪ̯ɪ
распоряжение	rəspərʲɪˈʐɛnʲɪjə
расправа	rɐsˈprɑvɨ
распродажа	rəsprɐˈd̪äʐə
рассвет	rɐsˈvʲetɨ
рассечение	rəsʲːɪˈt͡ɕenʲɪjə
рассольник	rɐˈsːolʲnʲɪk
расставание	rəsːtɐˈvanʲɪjə
расстрел	rɐˈstrʲeɫ
рассуждение	rəsːʊʐˈdʲenʲɪjə
рассыльщик	rɐˈsːɨlʲɕːɪkʲɪ
раствор	rɐsˈtvor
растение	rɐˈsʲtʲenʲɪ̝jə
растяпа	rɐs̪ˈtʲapɨ
расхлябанность	rɐsʲxlʲæbənːəsʲtʲ
расход	rɐs̪ˈxo̞t̪
расходомер	rəsxədɐˈmʲer
расцвеченный	rɐsˈtsvʲeʨɪnːɨjɪ
расчленение	rəsʲt͡ɕlʲɪˈnʲenʲɪjə
расчёска	rɐˈɕːɵskə
расчётка	rɐˈɕːɵtkʲɪ
расшива	rɐˈʂːɨvɨ
ратник	ˈrɑtʲnʲɪkʲɪ
рать	rätʲ
рация	ˈratsɨɪ
рашпер	ˈraʂpʲɪr
рашпиль	ˈraʃpʲɪlʲ
рвота	ˈrvotə
ре-бемоль	rɛbʲɪmˈolʲɪ
ре-диез	rɛdiˈɛza
реабилитация	rʲɪəbʲɪlʲɪˈtɑtsɨɪ
реал	rʲɪˈɑlɨ
реанимация	rʲɪɐnʲɪˈmatsɨɪ
ребро	rʲɪbˈro
ребятишки	rʲɪbʲɪˈtʲiʂkʲɪ
ребёнок	rʲɪˈbʲɵ̞nək
револьвер	rʲɪvʌlʲˈvʲɛrɨ
ревун	rʲɪvʊˈnɨ
редактор	rʲɪˈdaktər
рез	ˈrʲezɨ
резак	rʲɪˈzak
резание	ˈrʲezənʲɪjə
резерфордий	rʲɪzʲɪrˈfordʲɪɪ
резидент	rʲɪzʲɪˈdʲentɨ
резинка	rʲɪˈzʲinkʲɪ
резня	rʲɪzʲˈnʲæ
результат	rʲɪzʊlʲˈtatɨ̞
резь	ˈrʲezʲɪ
рейв	ˈrɛɪ̯vɨ
рейс	rʲeɪ̯s
рейх	ʀʲejx
река	ˈrʲekʲɪ
рекомендатель	rʲɪkəmʲɪnˈdatʲɪlʲɪ
рекомендация	rʲɪkəmʲɪnˈdatsɨɪ
рекрутер	rʲɪˈkrutʲɪr
рекрутинг	rʲɪˈkrutʲɪŋk
рекрутмент	rʲɪˈkrut̪mʲɪn̪t̪
ректификация	rʲɪktʲɪfʲɪˈkat͡sɨɪ
релевантность	rʲɪlʲɪˈvantnəsʲtʲɪ
религия	rʲɪˈlʲigʲɪjə
рельс	ˈrʲelʲsɨ
рельса	ˈrʲelʲsɨ
ремейк	rʲɪˈmɛɪ̯k
ремесленник	rʲɪˈmʲeslʲɪnʲːɪkʲɪ
ремесло	rʲɪmʲɪsˈɫo
ремиз	rʲɪˈmʲis
ремиссия	rʲɪˈmʲisʲːɪjə
ремонт	rʲɪˈmont
ремонтник	rʲɪˈmo̞n̪t̪nʲɪkʲɪ
рений	ˈrʲenʲɪɪ
реникса	rʲɪˈnʲiksə
репа	ˈrʲepə
репетиция	rʲɪpʲɪˈtʲit͡sɨɪ
репортёр	rʲɪpɐrˈtʲɵrɨ
репост	rʲɪˈpo̞stɨ
ресница	rʲɪsʲˈnʲit͡sɨ
ретина	rʲɪˈtinɨ
ретроспектива	rʲɪt̪rɐs̪pʲɪkˈtʲivɨ
ретушевальный	rʲɪtʉʂəˈvalʲnɨjə
ретушь	ˈrʲetʊʂ
реферал	rʲɪfʲɪrˈaɫɨ
референция	rʲɪfʲɪˈrʲent͡sɨjɪ
рехаб	rʲɪˈxabɨ
речистый	rɪt͡ɕisʲtɨɛ
речушка	rʲɪˈʨʉʂkʲɪ
речь	ˈrʲet͡ɕɪ
решебник	rʲɪˈʂɛbnʲɪk
решетник	rʲɪˈʂɛt⁽ʲ⁾nʲɪk
решето	rʲɪʂɨˈt̪o
ржа	rʐä
ржавчина	ˈrʐäft͡ɕɪn̪ɨ
ржавь	ˈrʐavʲɪ
ржака	ˈrʐakʲɪ
ржач	ˈrʐat͡ɕɪ
рибонуклеаза	rʲɪbənʊklʲɪˈazɨ
рибосома	rʲɪbɐˈsomɨ
ридер	ˈrʲidɛr
риелтер	rʲɪˈɛɫtɛrɨrʲɪˈjeɫtɛrɨˈrʲiɛɫtɛrɨ
риелтор	rʲɪˈɛltər
риелторша	rʲɪˈɛltərʂɨ
риск	ˈrʲiskʲɪ
рискователь	rʲɪs̪kɐˈvätʲɪlʲɪ
рислинг	ˈrʲis⁽ʲ⁾lʲɪnk
рисоварка	rʲɪsɐˈvarkə
ристалище	rʲɪˈstalʲɪɕːə
ритм	ˈrʲitmɨ
риторика	rʲɪˈtorʲɪkɪ
рифлёный	rʲɪfˈlʲɵnɨj
рифма	ˈrʲifmə
робот	ˈrobət
ров	rof
рогейн	rɐgʲejnɨ
рогоносец	rəɡɐˈnost͡sɨ
родий	ˈrodʲɪɪ
родинка	ˈrodʲɪnkʲɪ
родной	rɐdˈnoj
рододендрон	rədɐˈdɛndrən
родословие	rəd̪ɐˈs̪ɫ̪o̞vʲɪɪ̯ə
родстер	ˈrotstərɨ
рожок	ˈroʂkʲɪ
рожь	roʂ
розелла	rɐˈzɛɫːə
розетка	rɐˈzʲetkʲɪ
розочка	ˈrozəʨkʲɪ
рококо	rəkɐˈko
ролик	ˈrolʲɪk
роман	rɐˈmɑn
ромб	romp
роса	rɐˈsa
роскошь	ˈroskəʂɨ
роспуск	ˈrospʊskʲɪ
россиянин	ɾəsʲɪˈjænʲɪn
ростовчанка	rɐstɐfˈtɕankə
росточек	rɐs̪ˈt̪ot͡ɕkʲɪ
ростр	ˈrostrɨ
рот	rt̪ɨ
ротацизм	rətɐˈt͡sɨzm
ротище	rəˈtʲiɕːɪ
ротозей	rətɐˈzʲej
ротор	ˈrotər
роща	ˈroɕːə
ртище	ˈrtʲiɕːə
рубеж	rʊˈbʲeʂ
рублишко	rʊbˈlʲiʂkʲɪ
ругательство	rʊˈgatʲɪlʲstvə
руда	ˈrud̪ɨ
ружьё	rʊʐˈjɵ
руина	rʊˈinɨ
рука	rʊˈka
рукав	rʊkɐˈva
руккола	ˈrukəɫə
руководитель	rʊkəvɐˈdʲitʲɪlʲ
руководство	rʊkɐˈvotstvə
рукоделие	rʊkɐdʲelʲɪɪ̯ə
рукоприкладство	rʊkəprʲɪˈklatstvə
рулада	rʊˈladə
румын	rʊˈmɨn
русалка	rʊˈsaɫkʲɪ
русин	rʊˈsʲin
русло	ˈrusɫə
русофобия	rʊsɐˈfobʲɪjə
русофобский	rʊsɐˈfopskʲɪj
русская	ˈruskəjə
руте	rʊˈtɛ
рутений	rʊˈtɛnʲɪɪ
рутер	ˈrutɛrɨ
ручей	rʊˈtɕej
ручник	rʊʂˈnʲik
рыба	ˈrɨbɨ
рыба-зебра	ˈrɨbəˈzʲebrə
рыбак	rɨbɐˈkʲɪ
рыбина	ˈrɨbʲɪnə
рыбка	ˈrɨpkə
рыло	ˈrɨɫə
рысёнок	rɨˈsʲɵnək
рытвина	ˈrɨtvʲɪnɨ
рычание	rɨˈʨænʲɪjə
рюх	rjuːh
рябинка	rʲɪˈbʲinkʲɪ
рябинник	rʲɪˈbʲinʲːɪk
рябчик	ˈrʲɑptʃʲɪkɪ
ряд	rʲat̪
рядовой	rʲɪdɐˈvoj
рядок	rʲɪˈdok
ряженка	ˈrʲaʐɨ̞nkə
ряшка	ˈrʲæɕkə
саблист	sɐbˈlʲistɨ
сабля	ˈsɑblʲɪ
саван	ˈsɑvən
савант	s̪ɐˈvan̪t̪
саджа	sɐˈd͡ʑa
садист	s̪ɐˈdʲis̪t̪
садомазохизм	ˌsadəməzɐˈxʲizmɨ
садюга	sɐˈdʲʉ̞ɡʲɪ
садюшка	sɐˈdʲʉ̞ʂkə
сажа	ˈsaʐɨ
саженец	ˈsaʐɨnʲɪt͡s
сажень	ˈs̪äʐɨnʲɪ
сайга	sɐjˈgʲi
сайгак	sɐjˈgakʲɪ
сайка	ˈsɑjkʲɪ
сайт	saɪ̯t
сак	ˈsɑkʲɪ
саквояж	səkvɐˈjæʂ
сакля	ˈsaklʲɪ
саксонка	sɐkˈsonkə
салака	sɐˈlakʲɪ
саламандра	səlɐˈmandrə
салат	sɐˈɫ̪ät̪ɨ
сало	ˈs̪aɫ̪ə
салон	sɐˈɫon
сальник	ˈsalʲnʲɪk
салют	sɐˈlʲʊt
самарий	sɐˈmarʲɪj
самец	sɐˈmʲets
самка	ˈsɑmkə
самоанец	səmɐˈant͡sɨ
самовар	səmɐˈvar
самовнушение	səməvnʊˈʂɛnʲɪjə
самогон	səmɐˈgon
самодержец	səmɐˈdʲerʐət͡s
самоирония	səməɪˈronʲɪjə
самолёт	səmɐˈlʲɵtɨ
самомассаж	səməmɐˈsːaʂɨˌsaməmɐˈsːaʂɨ
самомнение	s̪əmɐˈmnʲenʲɪɪ̯ə
самооправдание	səməːprɐvˈdanʲɪjə
самоотвод	səməɐtˈvot
самопожертвование	səməpɐˈʐɛrtvəvənʲɪjə
самоубийство	səməʊˈbʲijstvə
самоубийца	səməʉˈbʲijtsə
самоуслаждение	s̪əməʊs̪ɫ̪ɐʐˈdʲenʲɪɪ̯ə
самохвальство	səmɐˈxvalʲstvə
сангина	sɐnˈgʲinə
сани	ˈsanʲɪ
санитар	sɐnʲɪˈtaɾ
санкция	ˈsankt͡sɨjɪ
санкюлот	sən̻kʉˈɫot
сантехник	sɐn̻ˈtʲexnʲɪkʲɪsɐn̻ʲˈtʲexnʲɪkʲɪ
сапетка	sɐˈpʲetkə
сапог	sɐˈpok
сапожище	səpɐˈʐɨɕːə
сапожник	sɐˈpoʐnʲɪkʲɪ
сапожок	səpɐˈʐok
сапфир	sɐˈpʲfʲir
сарафан	sərɐˈfɑnɨ
саржа	ˈs̪arʐɨ
сарказм	sɐrˈkazm
саркома	sɐrˈkomɨ
саркофаг	sərkɐˈfak
сарма	s̪ɐrˈma
сатана	sətɐˈna
сатанизм	sətɐˈnʲizm
сателлит	sətɛˈlʲit
сатирик	sɐˈtʲirʲɪk
сауна	ˈsaʊnɨ
сациви	sɐˈt͡sɨvʲɪ
сачкун	sɐʨˈkun
сачок	sɐʨˈkʲi
сбоить	sbɐˈitʲzbɐˈitʲ
сбор	zbor
свадьба	ˈsvatʲbɨ
сватовство	svətɐfˈstvo
сваха	ˈsvaxʲɪ
свекловица	svʲɪklɐˈvʲit͡sɨ
свекровь	svʲɪˈkrofʲ
свержение	svʲɪrˈʐɛnʲɪjə
сверло	ˈsvʲɵrɫə
сверстник	ˈsversnʲɪk
сверхмолния	svʲerxˈmolnʲɪjɪ
сверхчеловек	ˌsʲvʲerxt͡ɕɪɫɐˈvʲek
светло-голубой	ˈsvʲetləɡəlʊˈboj
светлость	ˈs̪vʲet͡ɫəsʲtʲ
светлота	svʲɪtˈɫotɨ
светодиод	svʲˌetədʲɪˈot
светотень	svʲɪtɐˈtʲenʲ
светоч	ˈsvʲetət͡ɕ
свиданье	svʲɪˈdanʲjə
свинг	ˈs̪vʲin̪ɡʲɪ
свинец	svʲɪˈntsɨ
свинка	ˈsvʲɪnkɪ
свинтус	ˈsvʲintʊsɨ
свинья	svʲɪˈnʲjæ
свирель	svʲɪˈrʲelʲɪ
свиток	ˈsvʲitək
свияга	s̪vʲɪˈɪ̯äɡʲɪ
свобода	svɐˈbodɨ
свод	ˈsvodɨ
сволочь	ˈs̪vo̞ɫ̪ət͡ɕɪ
свора	ˈsvo̞rə
свясло	ˈsvʲasɫə
святки	ˈsvʲætkʲɪ
святорусский	svʲɪtɐˈruskʲɪj
свёкла	ˈsvʲɵklə
свёкор	ˈsvʲɵkrɨ
сглаз	ˈzɡɫazɨ
сделка	ˈzʲdʲeɫkʲɪ
сдоба	ˈzdobɨ
север	sʲɪvʲɪˈra
северянин	sʲɪvʲɪˈrʲænʲɪ
севооборот	sʲɪvəəbɐˈrotˌsʲevəəbɐˈrot
сегвей	sʲɪˈgvɛj
сегмент	sʲɪgˈmʲent
сегрегация	sʲɪgrʲɪˈgat͡sɨjə
седан	sʲɪˈdanɨ
седло	sʲɪdˈɫo
сейл	ˈsɛɪ̯ɫɨ
секатор	sʲɪˈkatərɨ
секач	sʲɪkɐˈʨi
секель	ˈsʲekʲɪlʲɪsʲɪkʲɪˈlʲæ
секельда	sʲɪkʲɪlʲˈd̪ɨ
секиль	sʲɪkʲɪˈlʲæ
секира	sʲɪˈkʲirɨ
секрет	sʲɪkˈrʲet
секретарь	sʲɪkrʲɪˈtarʲ
секс-шоп	sʲeks̪ˈʂo̞pɨ
сексот	sʲɪkˈs̪o̞t̪
секста	ˈsɛkstə
секта	ˈsʲektɨ
сектор	ˈsʲektərɨ
секундант	sʲɪkʊnˈdantɨ
секундочка	sʲɪˈkundət͡ɕkʲɪ
секция	ˈsʲekt͡sɨjə
селитра	sʲɪˈlʲitrɨ
село	sʲɪˈɫo
сельдеобразный	sʲɪlʲdʲɪɐˈbraz̪n̪ɨɪ̯
сельдерей	sʲɪlʲdʲɪˈrʲej
сельский	ˈsʲelʲskʲɪj
сельскохозяйственный	sʲɪlʲskəxɐˈzʲæjstvʲɪnɨjə
сельчанин	sʲɪlʲˈt͡ɕænʲɪn
семантика	sʲɪˈmanʲtʲɪkə
семафор	sʲɪmɐˈfor
семейство	sʲɪ̝ˈmʲeɪ̯stvə
семигранник	sʲɪmʲɪˈgranʲːɪk
семидесятилетие	sʲɪmʲɪdʲɪsʲɪtʲɪˈlʲetʲɪɪ̯əsʲɪˌmʲidʲɪsʲɪtʲɪˈlʲetʲɪɪ̯ə
семихуй	sʲɪmʲɪˈxuɪ̯
семпл	ˈsɛmpɫɨ
семя	sʲɪmʲɪˈn̪a
сенсация	sʲɪnˈsat͡sɨjɪ
сенсор	ˈsɛnsərɨ
сенсуализм	sʲɪnsʊɐˈlʲizmɨ
сентябрь	sʲɪnʲˈtʲæbərʲ
сень	sʲenʲ
сепаратизм	sʲɪpərɐˈtʲizm
сепаратор	sʲɪpɐˈɾatər
сепулька	sʲɪˈpulʲkʲɪ
сера	ˈsʲerə
сербохорватский	sʲerpskəxɐrˈvat͡skʲɪjɪ
сербскохорватский	sʲerpskəxɐrˈvat͡skʲɪjɪ
сердечник	sʲɪrˈdʲeʨnʲɪk
сердце	ˈsʲertsə
сердцебиение	sʲɪrt͡sɛbʲɪˈjenʲɪjə
середа	sʲɪrʲɪˈdä
сержант	sʲɪɾˈʐɑntɨ
серия	ˈsʲerʲɪː
сермяжник	sʲɪrˈmʲæʐnʲɪk
серпянка	sʲɪrˈpʲan̪kʲɪ
серьга	sʲɪrʲˈga
сестра	sʲɪˈstra
сеструха	sʲɪˈs̪t̪ruxʲɪ
сет-лист	sətˈɫʲist
сеть	ˈsʲetʲɪ
сечение	sʲɪˈʨenʲɪjə
сечка	ˈsʲet͡ɕkə
сечь	sʲeʨʲɪ
сеятель	ˈsʲejɪtʲɪlʲɪ
сжатие	ˈʑːatʲɪ̝jə
си-бемоль	sʲibʲɪˈmolʲɪ
си-диез	sʲidiˈɛs
сибас	ˈsʲibəs̪ɨ
сибирец	sʲɪˈbʲɪrt͡sɨ
сибирка	sʲɪˈbʲirkə
сибирщина	sʲɪˈbʲɪrʲɕɕɪn̪ə
сибиряк	sʲɪbʲɪˈrʲäk
сивер	ˈsʲivʲɪr
сивуха	sʲɪˈvuxə
сига	ˈsʲiɡə
сигарилла	sʲɪɡɐˈrʲiɫɨ
сигма	ˈsʲigmɨ
сигнал	sʲɪgˈnɑɫ
сида	ˈsʲidə
сидение	sʲɪˈdʲenʲɪjə
сиеста	sʲɪˈjestə
сикель	ˈsʲikʲɪlʲsʲɪkʲɪˈlʲæ
сила	ˈsʲiɫɨ
силач	sʲɪˈɫɑʨ
силикон	sʲɪlʲɪˈkon
силовик	sʲɪɫəvʲɪˈkʲɪ
силок	sʲɪˈɫok
силос	ˈsʲiɫəs
силуэт	sʲɪɫʊˈɛtɨ
сильф	sʲilʲf
символ	ˈsʲimvəɫ
символист	sʲɪmvɐˈlʲist
симка	ˈsʲimkʲɪ
симплока	ˈsʲimpɫəkʲɪ
симулянт	sʲɪmʊˈlʲæntɨ
синапсид	sʲɪnɐˈpsʲit
синица	sʲɪˈnʲitsə
синоним	sʲɪˈnonʲɪmɨ
синопсис	ˈsʲinəpsʲɪsɨsʲɪˈnopsʲɪsɨ
синтаксис	ˈsʲintəksʲɪsɨ
синтезатор	sʲɪntəˈzatər
синтоизм	sʲɪntɐˈizmɨ
синьор	sʲɪnʲˈjɵr
сип	sʲip
сирота	sʲɪrɐˈta
систематичность	sʲɪsʲtʲɪmɐˈtʲiʨnəsʲtʲɪ
сиська	ˈsʲisʲkə
ситец	ˈsʲitʲɪts
сито	ˈsʲitə
ситх	sʲitx
сифон	sʲɪˈfon
сияние	sʲɪˈjænʲɪjə
скабрёзник	s̪kɐbˈrʲɵzʲnʲɪk
скабрёзность	s̪kɐbˈrʲɵz̪n̪əsʲtʲɪ
сказ	ˈskazɨ
сказуемое	skɐˈzujəmɨjə
скайсёрфинг	s̪kɐɪ̯ˈsʲɵrfʲɪŋgɪ
скакалка	skɐˈkaɫkə
скала	skɐˈɫɨ
скалка	ˈskalkə
скалолазание	skəɫɐˈɫazənʲɪjə
сканирование	skɐˈnʲirəvənɪjə
скатерть	ˈs̪kätʲɪrtʲɪ
скачкообразный	s̪kɐt͡ɕkəɐˈbraz̪n̪ɨɪ
скачок	skɐʨˈkʲi
скварк	ˈs̪kvarkʲɪ
сквернословие	s̪kvʲɪrn̪ɐˈs̪ɫ̪ovʲɪɪ̯ə
скверность	ˈskvʲernəsʲtʲɪ
скептицизм	skʲɪptʲɪˈt͡sɨzm
скетч	ˈskʲet͡ɕːɪ
скимборд	skʲɪmˈbort
скитание	skʲɪˈtanʲɪjɪ
склад	ˈskɫadɨskɫɐˈdɨ
складка	ˈskɫatkʲɪ
склеп	ˈsklʲepɨ
склера	ˈsklʲerə
склонение	skɫɐˈnʲenʲɪjə
скобочник	ˈskobəʨnʲɪkʲɪ
сковорода	ˈskovərədɨ
сколка	ˈskoɫkə
скользкий	ˈskolʲskʲɪjə
скоморох	s̪kəmɐˈro̞xʲɪ
скоморошество	s̪kəmɐˈro̞ʂɨs̪t̪və
скорлупа	skɐrˈlupɨ
скороговорка	skərəgɐˈvorkʲɪ
скорпион	skərpʲɪˈon
скотник	ˈskotnʲɪkʲɪ
скраб	ˈskrabɨ
скретч	ˈskrɛt͡ɕɪ
скретч-карта	s̪krɛt͡ɕˈkart̪ɨ
скрининг	ˈskrʲnʲɪngʲɪ
скрип	ˈskrʲipɨ
скрипица	skrʲɪˈpʲit͡sɨ
скрипка	ˈskrʲipkə
скромность	ˈs̪kro̞mn̪əsʲtʲɪ
скромный	ˈskromnɨj
скрупулёзность	skrʊpʊˈlʲɵznəsʲtʲɪ
скука	ˈskukə
скула	skʊˈla
скульптура	skʊlʲpˈturə
скупость	ˈskupəsʲtʲɪ
слабоумие	sɫəbɐˈumʲɪjə
славянин	sləvʲɪˈnʲin
славянка	sɫɐˈvʲænkə
сладкоежка	ˌslətkɐˈjɛʂkʲɪ
сладость	ˈsɫadəsʲtʲ
сластолюбец	sləstɐˈlʲʉbʲɪts
слеза	ˈs̪lʲɵz̪ɨ
сленг	sɫɛnk
слептон	s̪lʲɪpˈt̪on̪ɨ
слесарь	ˈslʲesərʲslʲɪsɐˈrʲæ
слив	ˈslʲif
слизняк	slʲɪzʲnʲɪˈkʲɪ
слизь	slʲizʲɪ
словарь	sɫəvɐˈrʲi
слово	sɫɐˈva
слово-паразит	ˈs̪ɫ̪o̞vəpərɐˈzʲit̪
словоизменение	sɫovəɪzmʲɪˈnʲenʲɪjə
словосочетание	sɫəvəsəʨɪˈtanʲɪjə
слог	s̪ɫo̞k
сложность	ˈsɫoʐnəsʲtʲɪ
слоистый	sɫɐˈistɨj
слонёнок	s̪ɫ̪ɐˈnʲɵn̪ək
служанка	sɫʊˈʐankə
слух	ˈsɫuxɪ
слюна	ˈslʲʉnɪ
слюнявчик	slʲʊˈnʲafʨɪk
слёток	ˈslʲɵtək
смартфон	smɐrtˈfonɨ
смелость	ˈsmʲeɫəsʲtʲ
смельчак	smʲɪlʲˈʨak
смена	ˈsmʲenɨ
сметана	smʲɪˈtänə
смешной	smɪʂˈnɨje
смирение	smʲɪˈrʲenʲɪjə
смирна	ˈsmʲirnɨ
смола	ˈs̪moɫ̪ɨ
смород	ˈsmo̞rədɨ
смрад	ˈsmrɑdɨ
смута	ˈsmut̪ə
смычок	smɨʨˈkʲi
снабжение	snɐbˈʐɛnʲɪjə
снаряд	snʌˈrʲat
снасть	ˈsnasʲtʲɪ
снег	sʲnʲɪˈga
снегирь	snʲɪgʲɪˈrʲi
снеговик	snʲɪgɐˈvʲik
снегопад	snʲɪgɐˈpadɨ
снедение	sʲnʲɪˈdʲenʲɪjə
снедь	ˈsnʲedʲɪ
снежинка	snʲɪˈʐɨnkə
снек	s̪n̪ɛk
сникер	ˈsnʲikʲɪr
снимка	ˈs⁽ʲ⁾nʲimkʲɪ
снисходительность	snʲɪsxɐˈdʲitʲɪlʲnəsʲtʲɪ
сноб	snop
снохачество	s̪n̪ɐˈxat͡ɕɪs̪t̪və
снукер	ˈsnukʲɪrɨ
сныть	snɨtʲ
собака	sɐˈbakə
собирательство	səbʲɪˈratʲɪlʲstvə
соболь	səbɐˈlʲa
собрание	sɐˈbranʲɪjə
собрат	brat
собственничество	ˈsopstvʲɪnʲːɪʨɪstvə
собственность	ˈsopstvʲɪnːəsʲtʲɪ
сова	ˈsovɨ
совершенство	səvʲɪrˈʂɛnstvə
совесть	ˈsovʲɪsʲtʲɪ
совет	s̪ɐˈvʲet̪ɨ
совокупность	səvɐˈkupn̪əsʲtʲ
соглядатай	səglʲɪˈdatəɪ
сода	ˈsodɨ
содержание	sədʲɪrˈʐanʲɪjə
содеяние	sədʲɪˈjænʲɪjə
соединение	səjɪdʲɪˈnʲenʲɪjə
сожительница	s̪ɐˈʐɨtʲɪlʲnʲɪt͡sɨ
созвучие	sɐˈzvuʨɪjə
создатель	s̪ɐˈz̪d̪atʲɪlʲɪ
созидание	s̪əzʲɪˈdanʲɪjə
сойка	ˈsojkʲɪ
сок	so̞k
соканье	ˈs̪okənʲjə
сокращение	səkrɐˈɕːenʲɪjə
сокровище	sɐˈkrovʲɪɕːɪ
солд-аут	sɐɫˈdaʊ̯tɨ
солидол	səliˈdoɬ
солод	ˈsolət
солома	sɐˈɫomɨ
соломосилосорезка	sɐˌɫoməˌsʲiɫəsɐˈrʲeskʲɪ
соль	ˈsolʲɪ
соль-бемоль	sɔlʲbʲɪmˈolʲ
соль-диез	sɔlʲdiˈɛza
солянка	sʌˈlʲænkə
сом	sɐˈmɨ
сома	ˈsomə
сомбреро	sɐmˈbrɛrə
сомнение	s̪ɐˈmnʲenʲɪɪ̯ə
сонаследование	sənɐˈslʲedəvənʲɪjə
сонграйтер	sɐnˈgraɪ̯tər
соникофан	s̪ənʲɪkɐˈfan̪
сонник	ˈs̪o̞nːʲɪk
сонограмма	s̪ən̪ɐˈgra̠mːɨ
соня	ˈsonʲɪ
соответствие	sɐːtˈvʲet͡stvʲɪjə
соотнесение	səːtnʲɪˈsʲenʲɪjə
соплеменник	səplʲɪˈmʲenʲːɪk
сопло	ˈsopɫə
сопля	ˈs̪o̞plʲɪ
сопоставление	səpəstɐvˈlʲenʲɪjə
сопредельный	səprʲɪˈdʲelʲnɨj
соразмерность	s̪ərɐz̪ˈmʲern̪əsʲtʲɪ
соратник	sɐˈratnʲɪk
сорога	sɐˈrogʲɪ
сорок	ˈsorək
сорока	sɐˈrokʲɪ
сорокапятка	sərəkɐˈpʲatkʲɪ
сороковины	sɐrɐkɐˈvʲinɨ
сорочины	sɐrɐˈtɕinɨ
сорочка	sɐˈrot͡ɕkʲɪ
сорт	sɐrˈta
сосенка	ˈsosʲɪnkʲɪ
сосец	sɐˈsʲet͡s
сосиська	sɐˈsʲisʲkə
соска	ˈsoskʲɪ
сословие	sɐˈsɫovʲɪɪ
сосна	sɐˈsna
сосок	sɐsˈkʲi
состав	s̪ɐˈs̪t̪ävɨ
сострадание	səstrɐˈdanʲɪjə
сосуд	sɐˈsut
сосулька	sɐˈsulʲkʲɪ
сотка	ˈsotkə
сотник	ˈsotnʲɪkʲɪ
сотрудник	sɐˈtrudnʲɪk
софа	sʌˈfa
софтина	s̪ɐfˈtʲin̪ɨ
социализм	sət͡sɨɐˈlʲizm
соцсеть	sot͡sˈsʲetʲɪ
сочельник	sɐˈt͡ɕelʲnʲɪk
сочетаемость	səʨɪˈtajəməsʲtʲ
союзник	sɐˈʲuznɪk
спад	spat
спазм	ˈspazmɨ
спальня	ˈspalʲnʲə
спаржа	ˈsparʐɨ̞
спарринг	ˈsparʲɪnk
спектакль	spʲɪˈktakl̩ʲ
спектралист	s̪pʲɪkt̪rɐˈlʲis̪t̪ɨ
спекулировать	spʲɪkʊˈlʲirəvətʲ
спекулянт	spʲɪkʊˈlʲænt
спекуляция	spʲɪkʊˈlʲæt͡sɨjə
сперма	ˈspʲermə
спермацет	spʲɪrmɐˈt͡sɛt
спесь	ˈspʲesʲɪ
спецзадание	spʲɪd͡zɐˈdanʲɪjə
специалист	spʲɪtsɨɐˈlʲist
специалистура	spʲɪt͡sɨəlʲɪˈst̪urə
специалитет	spʲɪt͡sɨəlʲɪˈtʲet
спешка	ˈspʲeʂkʲɪ
спин	ˈspʲinɨ
спина	ˈspʲinɨ
спираль	spʲɪˈralʲɪ
спискомания	s̪pʲɪs̪kɐˈmanʲɪɪ
список	ˈspʲisək
сплав	spɫaf
сплог	spɫok
сплошность	ˈs̪pɫ̪oʂn̪əsʲtʲ
спойлер	ˈspoɪ̯lʲɪr
спокойствие	spɐˈkoɪ̯stvʲɪjə
спокуха	spʌˈkuxə
спор	ˈsporɨ
спортсмен	spɐrtsˈmʲen
справедливоросс	sprəvʲɪdlʲɪvɐˈrosːɨ
справочник	ˈspravɐt͡ɕnʲɪk
спряжение	sprʲɪˈʐɛnʲɪjə
сражение	srɐˈʐɛnʲɪɪ̯ə
средоточие	s̪rʲɪd̪ɐˈt̪ot͡ɕɪjə
сродник	ˈsrod⁽ʲ⁾nʲɪk
ссака	ˈs̪ːakʲɪ
ссуда	ˈsːudɨ
ссыкун	s̪ːɨˈkun̪
стаб	s̪t̪ap
стабильность	s̪t̪ɐˈbʲilʲn̪əsʲtʲɪ
ставень	ˈstavɪnʲ
стагнация	stɐˈgnat͡sɨjə
сталкер	ˈs̪t̪äɫ̪kʲɪrɨ
становление	stənɐvˈlʲenʲɪjə
станочник	stɐˈnoʨnʲɪkʲɪ
старательство	stɐˈratʲlʲstvə
старение	stɐˈrʲenʲɪjə
старик	stərʲɪˈkʲi
старица	ˈstarʲɪtsə
старость	ˈstarəsʲtʲ
старьё	stɐˈrʲjɵ
статив	s̪t̪ɐˈtʲivɨ
стать	ˈstätʲɪ
статья	stɐˈtʲji
стачка	ˈstat͡ɕkʲɪ
стая	ˈstaɪ
стебелёк	sʲtʲɪbʲɪˈlʲɵk
стегание	sʲtʲɪˈganʲɪjə
стейк	ˈstɛɪ̯kʲɪ
стек	stɛk
стекло	stʲɪklo
стеклорез	stʲɪkɫɐˈrʲes
стеклянный	stʲɘkˈlʲænːᵻjɪ
стеклярус	sʲtʲɪˈklʲarʊs
стекольщик	stʲɪˈkolʲɕːɪk
стела	ˈstɛɫɨ
стена	sʲtʲɪˈna
стенгазета	stʲɪngɐˈzʲetə
стенд	ˈstɛndɨ
степенность	sʲtʲɪˈpʲenːəsʲtʲ
степист	stɛˈpʲistɨ
стерва	ˈstʲervə
стерх	sʲtʲerx
стетоскоп	stʲɪtɐˈskopɨstɛtɐˈskopɨ
стимул	ˈstʲimʊɫ
стимулирование	sʲtʲɪmʊˈlʲirəvənʲɪə
стимуляция	sʲtʲɪmʊˈlʲat͡sɨɪ̯ə
стипендия	sʲtʲɪˈpʲenʲdʲɪɪ̯ə
стиралка	sʲtʲiˈraɫkə
стихотворец	stʲɪxəˈtvoɾʲtsɨ
стог	stɐˈga
стойло	ˈstojɫə
стол	stoɫ
столб	stɐɫˈbɨ
столбчатость	ˈstoɫpt͡ɕɪtəsʲtʲ
столетие	stɐˈlʲetʲɪjə
столичный	stɐˈlʲiʨnɨjə
столкновение	stəɫknɐˈvʲenʲɪ̝jə
столовая	stɐˈɫovɨjə
столп	stɐɫ̪ˈpɨ
стольник	ˈstolʲnʲɪk
столяр	stəlʲɪˈrɨ
стон	ˈstonɨ
стопа	stɐˈpɨ
сторнирование	s̪t̪ɐrˈnʲirəvənʲɪɪ̯ə
сторож	stərɐˈʐa
сторона	s̪t̪ərɐˈn̪ä
стояк	stəiˈkʲi
страдание	strɐˈdanʲɪjə
страна-участница	strɐˈnaʊˈt͡ɕæs⁽ʲ⁾nʲɪt͡sə
странник	ˈstranʲɪkɪ
страпон	s̪t̪rɐˈpon̪
страсть	strasʲtʲɪ
стратегия	strɐˈtɛgʲɪjə
страхование	strəxɐˈvanʲɪjə
стрекоза	strʲɪkɐˈza
стрела	ˈstrʲeɫɨ
стрелок	strʲɪˈɫok
стрельба	ˈstrʲɛlʲbɨ
стрелялка	s̪t̪rʲɪˈlʲaɫkə
стремя	s̪t̪rʲɪmʲɪˈn̪ä
стретч	ˈstrɛt͡ɕɪ
строка	strɐˈkä
стронций	ˈstrontsɨj
стружка	ˈstruʂkə
струйка	ˈstrujkʲɪ
структура	strʊkˈturɨ
струя	strʊˈja
студийник	s̪t̪ʊˈdʲiɪ̯nʲɪk
студия	ˈstudʲɪjə
стул	stuɫ
ступень	stʊˈpʲenʲɪ
ступор	ˈstupərɨ
стыд	stɨˈdɨ
стычка	ˈstɨʨkʲɪ
стёб	ˈstɵ̞bɨ
суббота	suˈbotə
субвенция	sʊbˈvʲent͡sɨjɪ
субдоминанта	sʊbdəmʲɪˈnantə
субстанция	sʊpˈst̪an̪tsɪjə
субститут	sʊpsʲtʲɪˈtut
субъект	sʊbˈjɛktɨ
суверенность	sʊvʲɪˈrʲenːəsʲtʲɪ
сугроб	sʊˈɡrop
сугубый	sʊˈgubɨj
суд	sʊˈdɨ
судак	sʊdɐˈkʲi
сударь	ˈsudərʲɪ
судьба	ˈs̪udʲbɨ
сука	ˈs̪ukʲɪ
султан	suɬˈtanɨ
сулугуни	sʊɫʊˈgunʲɪ
сульфат	suɬˈfat
сумасшедший	sʊmɐˈʂɛtʂɨjə
сумасшествие	sʊmɐˈʂɛstvʲɪjə
сумка	ˈsumkʲɪ
сумма	ˈsumə
сумрак	ˈsumrəkʲɪ
сундук	sʊndʊˈkʲi
суннит	sʊˈnʲitɨ
суп	sʊˈpɨ
супер	ˈsupʲɪrɨ
супервайзер	sʊpʲɪrˈvajzʲɪrɨ
суперобложка	ˈsʉpsupjsupərɐˈbloʃkə
супруг	sʊˈpruk
супруга	s̪ʊpˈruɡʲɪ
сурьма	sʊrʲˈma
сусек	sʊˈsʲekʲɪ
суспензорий	sʊspʲɪnˈzorʲɪj
сутенёр	s̪ʊtʲɪˈnʲɵr
суффикс	ˈsufʲːɪks
сухожилие	sʊxɐˈʐɨlʲɪjə
сучка	ˈs̪ut͡ɕkə
сучоныш	s̪ʊˈt͡ɕɵn̪ɨʂ
суша	ˈsuʂɨ̞
суши	ˈsuʂɨ
суши-бар	ˈs̪uʂɨˈbärɨ
сушка	ˈsuʂkə
существительное	s̪ʊɕːɪˈs̪t̪vʲitʲɪlʲn̪əɪ̯əs̪ʊɕːɪˈsʲtʲvʲitʲɪlʲn̪əɪ̯ə
схватка	ˈsxvatkə
сцаки	ˈs̪t͡sakʲɪ
сцена	ˈstsɛnə
съезд	sjest
сыворотка	ˈsɨvərətkə
сын	sɨnɐˈvjæsɨˈnɨ
сыноубийство	sɨnəʊˈbʲijstvə
сыноубийца	sɨnəʊˈbʲijtsɨ
сыр	sɨˈrɨ
сыч	sɨʨ
сэр	s̪ɛr
сэсэн	sɛˈsɛn
сюжет	sʲʉˈʐɛtɨ
сюрреализм	sʲʊrʲːɪɐˈlʲiz̪mɨ
сюртук	sʲʉɾtʊˈki
сявка	ˈsʲäfkə
сёрфер	ˈsʲɵrfʲɪr
табак	təbɐˈkʲi
табасаранка	təˌbəsɐˈrankə
таблетка	tɐbˈlʲetkʲɪ
табулирование	təbʊˈlʲirəvənʲɪjə
табуляция	təbʊˈlʲæt͡sɨɪ
таволга	ˈtavəɫgʲɪ
тавот	tɐˈvot
тавр	ˈtavrɨ
тавро	ˈtavrə
тавтограмма	təftɐˈgramːə
тавтология	t̪ɐft̪ɐˈɫ̪ogʲɪɪ̯ɪ
таджик	tɐˈd͡ʑɨk
тазер	ˈtazʲɪr
тайга	t̪ɐɪ̯ˈgʲi
тайм	ˈtajmɪ
тайминг	ˈt̪äɪ̯mʲɪn̪ɡʲɪ
тайфун	tɐɪ̯ˈfunɨ
тайцзицюань	ˌtajd͡zʲɪt͡sʲʉˈanʲ
такса	ˈtaksə
таксация	tɐkˈsat͡sɨɪ
тактика	ˈtäktʲɪkʲɪ
талмудизм	təɫmʊˈdʲizm
тальник	tɐlʲˈnʲik
тамада	təmɐˈda
тамга	tɐmˈɡʲi
тампон	tɐmˈponɨ
тангенс	ˈtangʲɪns
тандем	tɐn̻ˈdɛmˈtan̻d̻əm
танзанийка	tənzɐˈnʲijkʲɪ
тантал	tɐnˈtɑɫ
тантризм	tɐnˈtrʲizmɨ
тапиока	təpʲɪˈokʲɪ
тапир	tɐˈpʲirɨ
тарабарщина	tərɐˈbarɕːɪnə
таракан	tərɐˈkanɨ
таран	tɐˈran
таратайка	tərɐˈtajkʲɪ
тарелка	tɐˈrʲeɫkʲɪ
тарзанка	tɐrˈzankʲɪ
тарикат	t̪ərʲɪˈkat̪
тархан	tɐrˈxanɨ
тата	ˈtatɨ
татарин	tɐˈtarɨtɐˈtarʲɪ
татарчонок	tətɐrˈʨætə
татуаж	tətʊˈaʐɨ
татуировка	tətʊɪˈrofkə
таунхаус	tɐʊnˈxaʊsɨ
тачка	ˈtat͡ɕkə
тварь	ˈtvɑrʲɪ
твердь	ˈtvʲerdʲɪ
твит	t̪vʲit̪
творец	tvɐˈrtsɨ
творог	ˈt̪vo̞rəɡʲɪt̪vərɐˈɡʲi
творожок	tvərɐˈʐok
театр	tʲɪˈɑtrɨ
тег	ˈtɛɡʲɪ
тезаурус	tɛˈzaʊrʊs
тезис	ˈtɛzʲɪsɨ
теист	tɛˈist
текила	tɨˈkʲilɨ
текстура	tʲɪksˈturə
телевещание	tʲɪlʲɪvʲɪˈɕːanʲɪjə
телега	tʲɪˈlʲegə
телегерой	tʲɪlʲɪɡʲɪˈroj
телезвезда	tʲɪlʲɪˈzvʲɵzdɨ
телекс	ˈtʲelʲɪksɨ
телепат	tʲɪʲɪˈpatɨ
телепатия	tʲɪʲɪˈpatʲɪː
телескоп	tʲɪlʲɪˈs̪ko̞pɨ
телец	tʲɪlʲˈtsɨ
телик	ˈtʲelʲɪkʲɪ
тело	ˈtʲeɫə
телогрейка	tʲɪlɐɡˈrʲejkə
телодвижение	tʲɪɫədvʲɪˈʐɛnʲɪjə
телосложение	tʲɪɫəsɫɐˈʐɛnʲɪjə
тельник	ˈtʲɛlʲnʲɪkɪ
тельняшка	tʲɪlʲˈnʲaʂkʲɪ
теля	tʲɪˈlʲæ
телёнок	tʲɪˈlʲɵnək
тема	ˈtʲemɨ
темнота	tʲɪmnɐˈta
темпера	ˈtɛmʲpʲɪrɨ
темперамент	tʲɪmʲpʲɪˈramʲɪnt
температура	tʲɪmʲpʲrɐˈturə
темя	ˈtʲemʲə
тенденция	tɛnˈdɛntsɨjə
теннисист	t̪ɛnʲɪˈsʲɪs̪t̪
тенор	ˈtʲenər
тень	ˈtʲenʲ
теорема	tʲɪɐˈrʲemə
теплица	tʲɪpˈlʲitsə
тепловизор	tʲɪpɫɐˈvʲizər
тепловоз	tʲɪpɫɐˈvos
теплоёмкость	tʲɪˈplo̞ˈjo̞mkəsʲtʲ
теракт	tʲɪˈrakt
терапевт	tʲɪrɐˈpʲeftɨ
тератома	tʲɪrɐˈtomɨ
териак	tʲɪrʲɪˈak
терминал	tʲərmʲɪˈnɑɫ
термит	tʲɪrˈmʲɪt
термитник	tʲɪrˈmʲit̻nʲɪk
термодинамика	ˌtɛrmədʲɪˈnamʲɪkəˌtʲermədʲɪˈnamʲɪkə
термометр	tʲɪrˈmomʲɪtr
термоодеяло	ˌtɛrmɐɐdʲɪˈjaɫə
термопара	tɛrmɐˈparə
терморегуляция	ˌtɛrmərʲɪɡʊˈlʲat͡sɨɪ
термос	ˈtɛrməs
терние	ˈtʲernʲɪjə
терновник	tʲɪrˈnovnʲɪkʲɪ
терренкур	tɛrənˈkurɨ
терроризм	tʲerɐˈrʲiz̪mt̪ɛrɐˈrʲiz̪m
тест	tɛst
тестенёк	tʲɪsʲtʲɪnʲˈkʲi
тестирование	tɨsʲˈtʲirəvənʲɪjə
тесто	ˈtʲestə
тестостерон	t̪ɛs̪t̪əs̪t̪ɛˈro̞n̪
тесть	tʲesʲtʲ
тетерев	tʲɪtʲɪrʲɪˈva
тетрагидроканнабинол	tʲɪtrəɡʲɪdrəkənːəbʲɪˈnol
тетралогия	tɛtrɐˈɫogʲɪː
тетёха	tʲɪˈtʲɵxə
теургия	tɛʊrˈgʲijə
тефтели	ˈtʲeftʲɪlʲɪtʲɪfˈtʲelʲɪ
техасец	tʲɪˈxast͡sɨ
технеций	tʲɪxˈnʲetsɨj
технология	tʲɪxnɐˈɫogʲɪjə
техрайтер	tʲɪˈxraɪ̯tɛr
течь	tʲetɕ
тигель	ˈtʲiɡʲɪlʲ
тигр	ˈtʲigrɨ
тизер	ˈtʲizʲɪr
тильда	ˈtʲilʲdə
тиляпия	tʲɪˈlʲæpʲɪɪ̯ə
тип	tʲip
типограф	tʲɪˈpogrəf
типология	tʲɪpɐˈɫogʲɪː
тирада	tʲɪˈradə
тире	tʲɪˈrɛ
титушка	tʲɪˈt̪uʂkʲɪ
титька	ˈtʲitʲkə
тихарь	tʲɪˈxarʲ
тихоня	tʲɪˈxonʲɪ
тишина	tʲɪʂɨ̞ˈna
тишь	ˈtʲiʂɨ̞
ткань	ˈtkanʲɪ
ткач	tkɐˈt͡ɕi
тоболец	tɐˈbo̞lʲɪt͡s
товар	tɐˈvar
товарищ	tɐˈvarʲɪɕːɪ
товарищество	tʌˈvarʲɪɕːɪstvə
товарняк	t̪əvɐrnʲɪˈkʲi
товарообмен	təvərəɐbˈmʲentɐˌvarəɐbˈmʲen
тожество	ˈtoʐəstvə
токарь	ˈtokərʲ
токсикоз	təksʲɪˈkos
толеразм	t̪əlʲɪˈräz̪m
толераст	t̪əlʲɪˈräs̪t̪ɨ
толерастия	t̪əlʲɪˈräsʲtʲɪɪ̯ə
толика	ˈtolʲɪkɪ
толока	t̪ɐˈɫ̪o̞kə
толстовка	tɐɫˈstofkʲɪ
толстосум	təɫstɐˈsum
толчок	t̪ɐɫ̪ˈt͡ɕok
толчёнка	t̪ɐɫˈt͡ɕɵn̪kə
томат	tɐˈmat
тон	ˈto̞nɨ̞tɐˈna
тонзура	t̪ɐn̪ˈz̪urə
тонкий	ˈt̪o̞n̪kʲɪjɪ
топоним	tɐˈponʲɪmɨ
топор	tɐˈpor
топсайдер	tɐpˈsaɪ̯dərɨ
торгаш	tɐrˈɡaʂ
торговец	tɐrˈgovtsɨ
торжество	tərʐɪˈstva
тормоз	ˈtorməs
тормозок	tərmɐˈzok
тормозуха	tərmɐˈzuxə
тортик	ˈtortʲɪkʲɪ
торфяник	tɐrˈfʲænʲɪk
торчок	tɐrʨˈkʲi
тост	ˈtostɨ
точность	ˈto̞ʨnəsʲtʲɪ
трава	ˈtravɨ̞
травля	ˈtravlʲɪ
травма	ˈtravmɨ
травник	ˈt̪ravnʲɪk
трагедия	trɐˈɡʲedʲɪ
трайпос	ˈt̪räjpəs̪
трактор	ˈt̪rakt̪ərɨ
тракторист	trəktɐˈrʲistɨ
тракторостроение	ˌtraktərəstrɐˈjenʲɪjə
трал	trɑɫ
транзистор	trɐnˈzʲistər
трансивер	trɐnˈsʲivʲɪr
транскрибирование	trənskrʲɪˈbʲirəvənʲɪjə
транскрипция	trɐnˈskrʲipt͡sɨjɪ
транслитерация	ˌt̪rɐn̪s̪lʲɪtʲɪˈrät͡sɨjə
трансляция	trɐnsˈlʲætsɨjə
транспортник	ˈtranspərtnʲɪkʲɪ
траншея	trɐnˈʂɛjə
трах	t̪rax
трахея	trɐˈxʲejə
треба	trʲebə
тревога	trʲɪˈvo̞gʲɪ
трек-лист	trɛˈkɫʲist
тремпель	ˈtrʲemʲpʲɪlʲ
тренд	ˈtrɛndɨ
трензель	ˈt̪rʲen̪zʲɪlʲɪt̪rʲɪn̪zʲɪˈlʲæ
трепет	ˈt̪rʲepʲɪt̪
трепло	ˈtrʲɵplə
третейский	trʲɪˈtʲejskʲɪjə
третины	trɪˈtʲinɨ
треугольник	trʲɪʊˈgolʲnʲɪk
триатлон	trʲɪɐtˈlonɨ
тривиализация	t̪rʲɪvʲɪəlʲɪˈz̪at͡sɨɪ
тригонометрия	trʲɪgənɐˈmʲetrʲɪjə
триграф	trʲɪˈɡrafɨ
трион	trʲiˈo̞nɨ̞
триумф	trʲɪˈumfɨ
трицератопс	trʲɪt͡sɨˈratəpsɨ
троллинг	ˈtrolʲɪngʲɪ
тропа	ˈtropɨ
тропинка	trɐˈpʲinkə
тростник	trɐsʲˈnʲik
тротуар	trətʊˈɑr
троцкизм	trɐt͡sˈkʲizm
труба	ˈt̪rubɨ
трубач	trʊˈbat͡ɕ
трубка	ˈtrupkə
трубница	ˈtrubnʲɪt͡sɨ
труд	t̪rut̪
труднопроизносимый	trʊdnəprəɪznɐˈsʲimɨj
трудолюбие	trʊdɐˈlʲʉbʲɪjə
трупак	ˈtrupəkʲɪ
трупарня	ˈtrupərnʲjə
трупик	ˈtrupʲɪk
труповозка	trʊpəˈvoskə
труппа	ˈtrupːə
трут	ˈtrutɨ
трутница	ˈt̪rut̪nʲɪt͡sə
трюкач	trʲʉˈkaʨ
трюм	trʲʉm
трюфель	ˈtrʲʉfʲɪlʲɪtrʲʉfʲɪˈlʲæ
тряпочка	ˈt̪rʲäpət͡ɕkə
трясогузка	trʲɪsɐˈguskʲɪ
трёпка	ˈtrʲɵpkə
трёхсложный	trʲɵxˈsɫ̪o̞ʐn̪ɨɪ̯
трёхэтажный	ˌt̪rʲɵxɪˈt̪äʐn̪ɨj
туба	ˈtubɨ̞
тубзик	ˈt̪ubzʲɪkʲɪ
тугрик	ˈtugrʲɪk
туес	tʊjɪˈsa
туесок	tʊjɪˈskʲi
туземец	tʊˈzʲemt͡sɨ
тузик	ˈtuzʲɪk
туклипс	t̪ʊˈklʲips̪
тумак	tʊˈmɑk
туманность	tʊˈmanːəsʲtʲɪ
тунеядец	tʊnʲɪˈjædʲɪt͡s
тупизм	t̪ʊˈpʲiz̪m
тупизна	t̪ʊpʲɪˈz̪n̪ä
тупой	tʊˈpɨjɪ
тупость	ˈtupəsʲtʲɪ
турацин	tʊrɐˈt͡sɨn
туризм	tʊˈrʲizm
турма	tˈurmɨ
тусовка	tʊˈsofkə
тута	ˈtutɨ
тучка	ˈtuʨkə
тушка	ˈtuʂkə
тушь	ˈt̪uʂɨ
тушёнка	tʊˈʂo̞nkʲɪ
тщеславие	tɕɪˈsɫavʲɪjə
тыква	ˈtɨkvə
тьмутаракань	tʲmʊtərɐˈkɑnʲɪ
тюль	ˈtʲʉlʲɪ
тюлька	ˈtʲʉlʲkə
тюльпан	tʲʊlʲˈpan
тюрьма	tʲʉrʲˈma
тяга	ˈtʲægə
тягомотина	tʲɪgɐˈmotʲɪnɨ
тяж	tʲaʂ
тяжба	ˈtʲæʐbə
тяжеловес	tʲɪʐəɫɐˈvʲesɨ
тяжесть	ˈtʲäʐɨ̞sʲtʲɪ
тяпка	ˈtʲɒpkɪ
тёзка	ˈtʲɵskʲɪ
тёлка	ˈtʲɵɫkə
тёрн	ˈtʲɵrnɨ
тётя	ˈtʲɵ̞tʲə
тёща	ˈtʲɵɕːə
убеждение	ʊbʲɪʐˈdʲenʲɪjə
убежище	ʊˈbʲeʐɨɕːə
убивание	ʊbʲɪvanʲɪje
убиение	ʊˈbʲijenʲɪje
убийство	ʊˈbʲijstvə
ублюдок	ʊbˈlʲʉdkɪ
убой	ʊˈboj
убор	ʊˈborɨ
убранство	ʊˈbranstvə
убыток	ʊˈbɨtək
убых	ʊˈbɨxʲɪ
увалень	ˈuvəlʲɪnʲ
уведомитель	ʊvʲɪdɐˈmʲitʲɪlʲɪ
увеличение	ʊvʲɪ̝lʲɪ̝ˈʨenʲɪ̝jə
углевод	ʉglɪˈvot
углерод	ʊɡlʲɪˈrot
уголь	ˈuglʲɪʊgˈlʲi
угонщик	ʊˈɡonʲɕɪk
угорь	ˈuɡərʲ
удавленник	ʊˈdavlʲɪnʲɪkʲɪ
удалец	ʊdɐˈlʲɛts
удалист	udɐˈlʲistɨ
ударение	ʊdɐˈrʲenʲɪjə
удлинитель	ʊdlʲɪˈnʲitʲɪlʲɪ
удовольствие	ʊd̪ɐˈvo̞lʲs̪t̪vʲɪɪ̯ə
удод	ʊˈdot
удостоверение	ʊdəstəvʲɪˈrʲenʲɪjə
удочка	ˈudət͡ɕkʲɪ
уж	ʊˈʐɨ
ужимка	ʊˈʐɨmkʲɪ
ужин	ˈuʐɨnɨ
узда	ˈuzdɨ
узкий	ˈuskʲɪɪ̯jə
узнаваемость	ʊznɐˈvɑɪməsʲtʲ
узник	ˈuzʲnʲɪkʲɪ
узор	ʊˈzor
узорчатый	ʊˈzorʨɪtɪjə
узус	ˈuzʊs
узы	ˈuzɨ
уйгур	ʉjˈgur
уйма	ˈujmə
укладка	ʊˈkɫatkʲɪ
укор	ʊˈkorɨ
укр	ʊkr
украинец	ʊkrɐˈinʲɪts
украинка	ʊkrɐˈinkʲɪ
укроп	ʊˈkrop
укрывательство	ʊkrɨˈvatʲɪlʲstvə
уксус	ˈuksʊs
укурок	ʊˈkurək
укус	ʊˈkusɨ
улан	ʊˈɫanɨ
улика	ʊˈlʲikɪ
уличка	ˈulʲɪt͡ɕkə
улов	ʊˈɫovɨ
улочка	ˈuɫət͡ɕkʲɪ
улус	uˈlusɨ
умерщвление	ʊmʲɪrɕˈvlʲenʲɪjə
умиление	ʊmʲɪˈlʲenʲɪjə
умиленье	ʊmʲɪˈlʲenʲjə
умник	ˈumnʲɪkʲɪ
умножение	ʊmnɐˈʐɛnʲjə
умолчание	ʊmɐɫˈʨænʲɪjə
унгаристика	ʊngɐˈrʲisʲtʲɪkʲɪ
ундина	ʊnˈdʲinə
универ	ʊnʲɪˈvʲerɨ
универмаг	ʊnʲɪvʲɪrˈmak
унификация	ʊnʲɪfʲɪˈkatsɨjə
уничижительный	ʊnʲɪʨɪˈʐɨtʲɪlʲnɨj
унунгексий	ʊnʊnˈgʲeksʲɪj
упокойник	ʊpɐˈkojnʲɪkʲɪ
упокойница	ʊpɐˈkojnʲɪtsə
упорство	ʊˈpors̪t̪və
упреждение	ʊprʲɪʐˈdʲenʲɪjə
упрощение	ʊprɐˈɕːenʲɪjə
упряжка	ʊˈprʲæʂkʲɪ
упряжь	ˈuprʲɪʂ
упрямство	ʊˈprʲäms̪t̪və
упырь	upɨˈrʲi
уравнивание	ʊˈravnʲɪvənʲɪjə
ураза	ʊrɐˈz̪ɨ
урбанист	ʊrbɐˈnʲist
урка	ˈurkʲɪ
уровень	ˈurəvʲɪ̝nʲ
урод	ʊˈrodɨ
ус	ʊˈsi
усач	ʊˈsatɕ
усик	ˈusɪkɪ
усики	ˈusɪkɪ
усиление	ʊsʲɪˈlʲenɪˈjə
усище	ʊˈsʲiɕːɪ
условность	ʊsˈɫovnəsʲtʲ
усложнение	ʊsɫɐʐˈnʲenʲɪjə
успение	uˈspʲenʲɪɪ̯ə
уста	ʊsˈta
устав	ʊsˈtaf
усталость	ʊˈstaɫəsʲtʲ
установитель	ʊstənɐˈvʲitʲɪlʲ
установка	ʊstɐˈnofkʲɪ
устойчивость	ʊˈstojʨɪvəsʲtʲɪ
устрашение	ʊstrɐˈʂɛnʲɪjə
устрица	ˈustrʲɪt͡sɨ
устройство	ʊˈstro̞jstvə
уступ	ʊˈstup
утечка	ʊˈtʲeʨkə
утешение	ʊtʲɪˈʂɛnʲɪjə
утка	ˈutkʲɪ
утконос	ʊtkɐˈnos
утопленник	ʊˈtoplʲɪnʲɪk
утопленница	ʊˈtoplʲɪnʲɪtsɨ
утренник	ˈutrʲɪnːʲɪk
утреня	ˈʉtɾʲɪnʲæ
утро	ˈut̪rə
утырок	uˈtɨrkʲɪ
утятница	ʊˈtʲætʲnʲɪtsə
ухаб	ʊˈxap
ухо	ˈuʂɨ
ухудшение	ʊxʊtˈʂɛnʲɪjə
участие	ʊˈʨæsʲtʲɪjə
участник	ʊˈt͡ɕæsʲnʲɪkʲɪ
учебник	ʊˈt͡ɕebnʲɪkʲɪ
ученик	ʊʨɪˈnʲik
учитель	ʊˈt͡ɕitʲɪlʲ
учтивость	ʊt͡ɕˈtʲivəsʲtʲ
учёба	ʊˈt͡ɕɵbɨ
ушанка	ʊˈʂankʲɪ
ушиб	ʊˈʂɨbɨ
уют	ʊˈjʉtɨ
уёбок	ʊˈjo̞bək
фа-бемоль	fɐbʲɪmˈolʲɪ
фа-диез	ˌfadʲɪˈjes
фабрикант	fəbrʲɪˈkan̻tɨ
фабула	ˈfabʊɫə
фаза	ˈfɑzɨ
фазан	fɐˈzanɨ
фазаний	fɐˈzanʲɪj
факел	ˈfakʲɪl
факир	fɐˈkʲirɨ
факультет	fəkʊlʲˈtʲet
фалангист	fəɫɐn̻ˈgʲist
фалафель	fɐˈɫafʲɪɫʲ
фальсификатор	fəlʲsʲɪfʲɪˈkatərɨ
фальшивомонетничество	fɐɫ̪ʲʂɨvəmɐˈn̪ʲt͡ɕɪs̪t̪və
фамилия	fɐˈmʲilʲɪ
фанат	fɐˈnatɨ
фанатизм	fənɐˈtʲizm
фандрайзинг	fɐn̪ˈd̪raɪ̯zʲɪŋk
фанерозой	fɐn̪ɛrɐˈz̪o̞ɪ
фантасмагория	fəntəsmɐˈgo̞rʲɪjə
фантом	fɐnˈtom
фанфарон	fənfɐˈron
фара	ˈfarə
фарад	fɐˈradɨ
фараон	fərɐˈonɨ
фарингоскоп	fərʲɪn̻gɐˈskopɨ
фармаколог	fərmɐˈkoɫək
фастфуд	fɐstˈfud̪ɨ
фасция	ˈfäs̪t͡sɨɪ̯ə
фатерланд	ˈfat̪ɛrɫən̪d̪ɨfət̪ɛrˈɫan̪d̪ɨ
фауна	ˈfäʊn̪ə
фацет	fɐˈtsɛt
фашизм	fɐˈʂɨzm
фашик	ˈfaʂɨk
фашист	fɐˈʂɨstɨ
февраль	fʲɪvˈralʲ
федеративный	fʲɪdʲɪrɐˈtʲivnɨj
феерия	fʲɪˈjeɾʲɪjə
фейк	fɛɪ̯k
фекал	fʲɪˈkaɫ̪ɨ
фельдмаршал	fʲɪlʲdˈmɑrʂəɫɨ
фельдъегерь	fʲɪlʲdˈjegʲɪrʲ
феминизация	fʲɪmʲɪnʲɪˈz̪ät͡sɨɪ
феномен	fʲɪˈn̪o̞mʲɪn̪ɨ
феня	ˈfʲenʲə
феод	fʲɪˈodɨ
феррозонд	fɛrɐˈzont
ферт	ˈfʲertɨ
фешенебельный	fʲɪʂɨˈnɛbʲɪlʲnɨjɪ
фиброид	fʲɪˈbroɪt
фига	ˈfʲi̝gʲɪ
фигура	fʲɪˈgurɨ
фигурант	fʲɪgʊˈrɑnt
фигурист	fʲɪgʊˈrʲistɨ
физик	ˈfʲiziki
физиология	fʲɪzʲɪɐˈɫoɡʲɪ
физиономия	fʲɪzʲɪɐˈnomʲɪjə
фикус	ˈfʲikʊsɨ
филантроп	fʲɪɫ̪ɐn̪ˈt̪ro̞pɨ
филе	fʲɪˈlʲe
филировка	fʲɪlʲɪˈrofkʲɪ
филология	fʲɪɫɐˈɫogʲɪjə
фильтр	ˈfʲilʲtr
финалист	fʲɪnɐˈlʲistɨ
фингал	fʲɪnˈgaɫ
финн	fʲinː
финт	fʲint
фирма	ˈfʲirmɨ
фича	ˈfʲit͡ɕə
флаг	ˈfɫagʲɪ
фламинго	fɫɐˈmʲinɡə
флегматик	flʲɪgˈmatʲɪkʲɪ
флеровий	flʲeˈrovʲɨɪ
флеш-память	flɛʂˈpamʲɪtʲ
флешка	ˈfɫɛʂkʲɪ
флешмоб	fɫɛʂˈmo̞p
флешь	flʲeʂ
флигель	ˈflʲiɡʲɪlʲ
флирт	flʲiɾt
флиш	flʲiʂ
флот	fɫot
флуоресцеин	flʊərʲɪst͡sɨˈinɨ
флюид	flʲʉˈit̪
фляга	ˈflʲægə
фляжка	ˈflʲaʂkə
фойе	fɐˈje
фокусник	ˈfokʊsnʲɪk
фольклор	fɐlʲkˈɫorfɐlʲkˈlʲɵr
фонарь	fɐˈnarʲ
фонема	fɐˈnɛmə
фонемный	fɐˈnɛmnɨje
фонетика	fɐˈnɛtʲɪkʲɪ
форкастель	fɐrˈkasʲtʲɪlʲ
формирование	fərmʲɪrɐˈvanʲɪjə
форс-мажор	ˌforsmɐˈʐo̞r
фортепиано	fərtɛˈpʲjanə
фортификация	fərtʲɪfʲɪˈkatsɨɪ
форумен	fərʊˈmɛnɨ
форумчанин	fərʊmˈtɕænʲɪn
фото	ˈfotə
фотоаппаратура	ˌfotəəpərɐˈturə
фотография	fətɐˈgrɑfʲɪjə
фотожаба	fətɐˈʐabɨ
фотолаборатория	ˌfot̪əɫ̪əbərɐˈt̪o̞rʲɪɪ̯ə
фотон	fɐˈto̞nɨ̞
фотополимер	ˌfotəpəlʲɪˈmʲerɨ
фотошкола	fət̪əʂko̞ɫ̪ɨ
фофан	ˈfofən
фрагмент	frɐgˈmʲent
фраер	ˈfraɪ̯ər
фразеология	frɐzʲɪɐˈɫ̪oɡʲɪɪ̯ə
франклин	ˈfran̻klʲɪn
франций	ˈfrantsɨɪ
француз	frɐnˈtsus
франшиза	frɐnˈʂɨzɨ
фреон	frʲɪˈonɨ
фривольный	frʲɪˈvolʲnɨjə
фриз	ˈfrʲizɨ
фризка	ˈfrʲiskə
фрик	ˈfrikʲɪ
фриц	frʲits
фронт	frɐn̪ˈt̪ɨ
фронтмен	ˈfrontmən
фронтон	frɐnˈtonɨ
фрустрация	frʊˈstrat͡sɨjə
фтор	ˈftorɨ
фугас	fʊˈgas
фуговка	fʊˈgo̞fkʲɪ
фуд-корт	fʊtˈkort
фуллерен	fʊlʲɪˈrʲenɨ
фундамент	fʊnˈdɑmʲɪnt
фундук	fʊnˈduk
фуникулёр	fʊnʲɪkʊˈlʲɵrɨ
функционал	fʊnktsɨɐˈnɑɫ
фура	ˈfurɨ
фургон	fʊɾˈɡonɨ
футарк	ˈfutərk
фуфло	ˈfufɫə
фьючерс	ˈfʲjʉʨɪrsɨ
фьючерсный	ˈfʲʉʨɪrsnɨj
хабалка	xɐˈbäɫ̪kə
хабарик	xɐˈbarʲɪkʲɪ
хадж	ˈxad̪ʐɨ
хадис	xɐˈdʲis̪
хайло	xaɪ̯ˈɫ̪o̞
хайп	xaɪ̯p
хайтек	xɐɪ̯ˈtɛkʲɪ
хакас	xɐˈkasɨ
халтура	xʌlˈturə
халтурщик	xʌɫˈturɕːɪ̝kʲɪ
халькоген	xəlʲkɐˈgʲenɨ
халява	xɐˈlʲavə
хамелеон	xəmʲɪlʲɪˈon
хамит	xɐˈmʲit̪ɨ
хамон	xɐˈmon̪
хамсин	xɐmˈsʲin̪ɨ
ханжа	xɐn̪ˈʐɨ
хаос	ˈxaəs
харакири	xərɐˈkʲirʲɪ
характеристика	xərəktʲɪˈrʲisʲtʲɪkʲɪ
хардкор	xɐrtˈkorɨ
харизма	xɐˈrʲizmɨ
хасидизм	xəsʲɪˈdʲizmɨ
хассий	ˈxasʲɪɪ
хата	ˈxɑtɨ
хауберг	ˈxaʊbʲɛrɡʲɪ
хауберк	ˈxaʊbɛrkʲɪ
хвастливость	xvɐst̻ˈlʲivəsʲtʲ
хват	ˈxvɑtɨ
хвост	xvo̞s̪t̪
хвостище	ɣvɐsˈtʲiɕːə
хвостовка	xvɐsˈtofkʲɪ
хедлайнер	xədˈɫaɪ̯nʲɪrɨ
хемотаксис	xɛmɐˈtaksʲɪsɨ
хентай	xɛnˈtaɪ
хер	xʲɪˈrɨ
херес	ˈxʲerʲɪsɨ
херувим	xʲɪrʊˈvʲimɨ
хетчбэк	xɛd͡ʑˈbɛk
хиазм	xʲɪˈazm
хиджаб	xʲidˈʐap
хижина	ˈxʲiʐɨnə
химера	xʲɪˈmʲerə
химизация	xʲɪmʲɪˈzat͡sɨɪ
химик	ˈxʲimʲɪk
хина	ˈxʲinə
хинди	ˈxʲinʲdʲɪ
хиромант	xʲɪrɐˈman̻t
хирург	xʲɪˈrurk
хитрец	χʲɪtˈrʲets
хитросплетение	xʲɪtrəsplʲɪˈtʲenʲɪjə
хищник	ˈxʲiɕnʲɪkʲɪ
хлад	xɫɑt
хлеб	xlʲɛ̝p
хлебало	xlʲɪˈbaɫ̪ə
хлебопекарня	xlʲɪbəpʲɪˈkɑrnʲɪ
хлебосольство	xlʲɪbʌˈso̞lʲstvə
хлев	xlʲef
хлопкороб	χləpkɐˈrop
хлорвинил	ˌxɫorvʲɪˈnʲiɫxɫərvʲɪˈnʲiɫ
хлороводород	xɫərəvədɐˈrot
хлястик	ˈxlʲæsʲtʲɪkʲɪ
хобби	ˈxobʲːɪ
ход	ˈxot
ходатайство	xɐˈdatəjstvə
ходок	xɐˈdok
ходуля	xɐˈdulɪ
хождение	xɐʐˈdʲenʲɪjə
хозяйство	xɐˈzʲæjstvə
хозяйствование	xɐˈzæɪ̯stvəvənʲɪjə
холка	ˈxo̞ɫ̪kʲɪ
холм	xɐɫˈmɨ
холод	xəɫɐˈda
холодильник	xəɫɐˈdʲi̝lʲnʲɪk
холодная	xɐˈɫodnəjə
холодостойкость	xəɫədɐˈstoɪ̯kəsʲtʲɪ
холокост	xəɫɐˈkost
холостяк	xɐɫ̪ɐˈsʲtʲak
холостёжь	xɐɫ̪as̪ˈtʲo̞ʂ
холява	xɐˈlʲævə
хомут	xɐˈmut̪
хомутик	xɐˈmutʲɪkʲɪ
хор	ˈxor
хорей	xɐˈrʲeɪ
хореограф	xərʲɪˈogrəfɨ
хорист	xɐˈrʲis̪t̪ɨ
хороним	xɐˈronʲɪm
хороняка	χərɐˈnʲækʲɪ
хорошист	xɐrɐˈʂɨstɨ
хоругвь	xɐˈrugvʲɪ
хорь	xɐˈrʲi
хоспис	ˈxospʲɪsɨ
хостел	ˈxos̪t̪ɛɫ̪
хохлатка	xɐxˈɫatkʲɪ
хохма	ˈxoxmɨ
хохмач	xɐxˈmɑt͡ɕ
хохмачество	xɐxˈmɑt͡ɕʲɪs̪t̪və
хохол	xɐxˈɫɨ
хохот	ˈxoxətɨ
хохотун	xəxɐˈtun
храбрость	ˈxrabrəsʲtʲ
храм	xrɑm
хранение	xrɐˈnʲenʲɪɪ̯ə
хребет	xrʲɪbˈtɨ
хрен	ˈxrʲen̪ɨ
хризантема	xrʲɪzɐnˈtɛmɨ
хрип	xrʲip
христианин	xrʲɪsʲtʲɪɐˈnʲin
христианка	xrʲɪsʲtʲɪɐˈnkɐ
хрусталик	xrʊsˈtɑlʲɪkʲɪ
хрящ	xrʲæɕː
художник	xʊˈdoʐnʲɪk
хуеплётка	xʊjɪˈplʲotkɪ
хуета	xʊɪˈt̪ɨ
хуила	xʊˈiɫ̪ə
хуило	xʊˈiɫ̪ə
хуище	xʊˈiɕːɪ
хуй	xuɪ̯
хук	ˈxukʲɪ
хула	xuˈɫɨ
хулиган	xʊlʲɪˈɡɑn
хулиганство	xʊlʲɪˈɡɑnstvə
хулиганьё	xʊlʲɪgɐˈnʲjo̞
ц	tsɛ
цапля	ˈt͡saplʲɪ
цапфа	ˈt͡sapfə
царапина	tsɐˈrɑpʲɪnə
царедворец	t͡sərʲɪˈdvort͡sɨ
цареубийство	tsɨrʲɪʊˈbʲijstvə
цареубийца	tsɐrʲɪʊˈbʲijtsɨ
царство	ˈt͡sars̪t̪və
царь	t͡sarʲ
цвет	t͡svʲet̪
цветок	t͡svʲɪˈt̪o̞k
цветь	t͡svʲetʲ
цевка	ˈtsɛfkʲɪ
цезура	tsɪˈzurɨ
цеканье	ˈt͡ɕɛkənʲjɪ
целитель	t͡sɨˈlʲitʲɪlʲɪ
целлюлоза	tsɪlʲʉˈlozɨ
целом	tsɛˈlomɨ
цемент	tsɨˈmʲent
цена	ˈt͡sɛn̪ɨ
цензор	ˈtsɛnzərɨ
ценительница	tsɨˈnʲitʲɪlʲnʲɪtsə
центнер	ˈt͡sɛnʲt̻nʲɪrɨ
централизм	t͡sɨntrɐˈlʲizm
центрировка	tsəntrʲɪˈrofkʲɪ
цеппелин	tsəpʲɪˈlʲin
цепь	ˈt͡sɛpʲɪ
церемониймейстер	tsɪrʲɪˌmo̞nʲɪjˈmʲejstʲɪr
церковник	t͡sɨrˈkovnʲɪk
церковь	ˈt͡sɛrkəfʲ
цесаревна	t͡sɨs̪ɐrʲevn̪ɨ
цетера	ˈt͡sɛt̪ɨrə
цивилка	t͡sɨˈvʲiɫkə
цикличность	tsɨkˈlʲiʨnəsʲtʲɪ
цилиндр	tsɨˈlʲindər
циник	ˈtsɨnʲɪk
цинкография	t͡sɨnkɐˈgrafʲɪː
цирконий	tsɨrˈkonʲɪj
цирюльник	t͡sɨˈrʲʉlʲnʲɪkʲɪ
цистерна	t͡sɨsˈtɛrnɨ
цитадель	tsɨ̞tɐˈdɛlʲ
цитата	t͡sɨˈtatɨ
цитация	t͡sɨˈt̪ät͡sɨɪ̯ə
цитирование	tsɨˈtʲirəvənʲɪjə
цитоплазма	t͡sɨt̪ɐˈpɫaz̪mə
цитотоксичность	tsɨtətɐkˈsʲiʨnəsʲtʲɪ
цитохром	tsɨtɐˈχrom
циферблат	tsɨfʲɪrˈbɫat
цифра	ˈtsɨfrɨ
цокальщик	ˈt͡sokəlʲɕːɪk
цугундер	t͡sʊˈɡun̪d̪ɛr
цунами	tsʊˈnɑmʲɪ
цыган	tsɨˈganʲɪ
цыганочка	tsɨˈgɑnəʨkʲɪ
цыплятник	t͡sɨpˈlʲæt̻ʲnʲɪkʲɪ
цыплёнок	t͡sɨpˈlʲatə
чабан	t͡ɕɪˈbanɨ
чавыча	t͡ɕɐˈvɨt͡ɕɪt͡ɕəvɨˈt͡ɕi
чадра	t͡ɕɪˈd̪rɨ
чаевод	t͡ɕɪjɪˈvodɨ
чаеводка	t͡ɕɪjɪˈvotkə
чай	t͡ɕaɪ̯
чайка	ˈʨæjkʲɪ
чайник	ˈʨajnʲɪk
чалка	ˈʨæɫkə
чалма	t͡ɕɪɫˈma
чамо	tʃɑmɔˈ
чан	ʨæn
чапаруха	ʨɪpɐˈruxʲɪ
чарка	ˈtɕærkʲɪ
чарнокит	t͡ɕɪrnɐˈkʲitɨ
чародей	ʨɪrɐˈdʲej
чарт	t͡ɕart̪
час	t͡ɕɪˈs̪ɨ
часовня	tɕɪˈsovnʲɪ
часослов	t͡ɕɪsɐˈsɫof
частотность	t͡ɕɪsˈtot̻n̻əsʲtʲɪ
частушка	t͡ɕɪs̪ˈt̪uʂkə
чахотка	t͡ɕɪˈxotkə
чахоточный	t͡ɕɪˈxotət͡ɕn̻ɨɪ
чахохбили	tɕɪxɐxˈbʲilʲɪ
чаша	ˈtɕaʂə
чекист	t͡ɕɪˈkʲist
чел	t͡ɕel
челночник	t͡ɕɪɫˈnot͡ɕnʲɪkʲɪ
чело	ˈtɕo̞ɫə
челобитчик	t͡ɕɪɫɐˈbʲit͡ɕːɪkʲɪ
человек	t͡ɕɪɫɐˈvʲek
человечество	tɕɪɫ̪ɐˈvʲetɕɪs̪t̪və
челюсть	ˈt͡ɕelʲʊsʲtʲ
чемодан	t͡ɕɪmɐˈd̪än̪ɨ
червы	ˈʨervɨ
червь	ˈt͡ɕervʲɪ
червяк	t͡ɕɪrvʲɪˈkʲi
чердак	t͡ɕɪrdɐˈkʲi
череда	ʨɪrʲɪˈdɨ
череп	ʨɪrʲɪˈpa
черепаха	ʨɪrʲɪˈpaxə
черепок	ʨɪrʲɪˈpkʲi
черешня	tɕɪˈrʲeʂnʲə
черкес	tɕɪrˈkʲɛsɨ
черкеска	tɕɪrˈkʲɛskɪ
черника	ʨɪrˈnʲikə
чернила	tɕɪrˈnʲiɫə
чернобыльник	tɕɪrnɐˈbɨlʲnʲɪk
черногорец	t͡ɕɪrnɐˈgorʲɪt͡s
чернозём	ʨɪrnɐˈzʲɵmɨ
чернослив	t͡ɕɪrn̪ɐˈs̪lʲif
чернь	ʨernʲɪ
чероки	tɕɪˈrokʲɪ
черта	ʨɪrˈtɨ
чертовщина	t͡ɕɪrt̪ɐfˈɕːin̪ɨ
чертог	t͡ɕɪrˈt̪o̞k
чертополох	ʨɪrtəpɐˈɫo̞x
чертёж	t͡ɕɪrtʲɪˈʐɨ
чертёжник	ʨɪrˈtʲɵʐnʲɪk
чертёжный	ʨɪrˈtʲɵʐnɨ̞j
чертёнок	tɕɪrtʲɪˈnʲætə
черчение	t͡ɕɪrˈt͡ɕenʲɪjə
черёмуха	t͡ɕɪˈrʲɵmʊxʲɪ
чеснок	t͡ɕɪs̪n̪ɐˈkʲi
честолюбие	ʨɪstɐˈlʲʉbʲɪjə
четвертак	ʨɪtvʲɪrˈtak
четвертьфинал	t͡ɕɪtvʲɪrtʲfʲɪˈnaɫɨˌt͡ɕetvʲɪrtʲfʲɪˈnaɫɨ
чечевица	t͡ɕɪt͡ɕɪˈvʲit͡sə
чечен	tɕɪˈtɕɛn
чеченец	tɕɪˈtɕɛntsɨ
чечётка	ʨɪˈʨɵtkə
чечёточник	ʨɪˈʨɵtəʨnʲɪk
чи	t͡ɕɪ
чибрик	ˈt͡ɕibrʲɪkʲɪ
чижик	ˈʨiʐɨkʲɪ
чикс	t͡ɕiks̪
чикса	t͡ɕɪkˈsaˈt͡ɕiksə
чиркаш	t͡ɕɪrkɐˈʂɨ
числитель	t͡ɕɪsˈlʲitʲɪlʲɪ
число	ˈt͡ɕis̪ɫ̪ə
чистик	ˈt͡ɕisʲtʲɪkʲɪ
чистюля	ʨɪˈstʲʉlʲə
читаемый	ʨɪˈtaɪmɨj
чих	t͡ɕixʲɪ
членение	t͡ɕlʲɪˈnʲenʲɪjə
чмо	t͡ɕmä
чмошник	ˈt͡ɕmoʂnʲɪkʲi
чорт	ˈt͡ɕertʲɪ
чреватость	t͡ɕrʲɪˈvät̪əsʲtʲɪ
чревовещание	t͡ɕrʲevəvʲɪˈɕːænʲɪjə
чревоугодие	ʨrʲəvəʊˈgo̞dʲɪ̝jə
чреда	ʨrʲɪˈda
чубчик	ˈt͡ɕʉpt͡ɕɪk
чувак	t͡ɕʊvɐˈkʲi
чувал	t͡ɕʊˈvaɫ̪
чудище	ˈtɕudʲɪɕːə
чудо	ˈʨʉdə
чудотворец	ʨʉdɐˈtvortsɨ
чудотворство	t͡ɕʊd̪ɐˈt̪vors̪t̪və
чуждость	ˈt͡ɕuʐd̪əsʲtʲ
чулан	t͡ɕʉˈɫanɨ
чурбак	ʨʊrbɐˈkʲi
чурка	ˈt͡ɕurkʲɪ
чутьё	t͡ɕʉtʲˈjɵ
чучела	ˈt͡ɕut͡ɕɪɫ̪ə
чучело	ˈt͡ɕut͡ɕɪɫ̪ə
чучхе	t͡ɕʉˈt͡ɕxʲe
чёлн	t͡ɕɪɫ̪ˈn̪ɨ
чёрт	ˈt͡ɕertʲɪ
чёс	ˈʨɵsɨ
чётки	ˈtʃʲotkʲi
шаблон	ʂɐbˈɫon
шавка	ˈʂäfkə
шаг	ʂɨˈgʲi
шагомер	ʂəgɐmʲerɨ
шайка	ˈʂajkʲɪ
шайтан	ʂɐjˈtan
шалава	ʂɐˈɫavɨ
шалаш	ʂəˈɫɐˈʂɨ
шалашовка	ʂɐɫ̪ɐˈʂofkʲɪ
шалопай	ʂəɫɐˈpaɪ
шалопайка	ʂəɫɐˈpajkɪ
шалунишка	ʂəɫʊˈnʲiʂkʲɪ
шалыга	ˈʂaɫ̪ɨɡʲɪ
шаматон	ʂəmɐˈton
шампанское	ʂɐmˈpanskəjə
шампур	ʂɐmˈpurɨ
шансон	ʂɐn̻ˈson
шантаж	ʂɐnˈtɑʂ
шантрапа	ʂɐn̪t̪rɐˈpa
шапочный	ˈʂapəʂnɨj
шар	ʂɐˈrɨ
шарабан	ʂərɐˈban
шарада	ʂɐˈrɑdɨ
шарик	ˈʂärʲɪkʲɪ
шарлотка	ʂɐrˈɫ̪o̞tkə
шарманка	ʂɐrˈmankə
шарманщик	ʂɐrˈmanʲɕːɪkʲɪ
шасталка	ˈʂastəlkə
шатание	ʂɐˈtɑnʲɪjə
шатен	ʂɐˈtɛn
шатия	ˈʂatʲɪjə
шатун	ʂətʊˈnɨ
шафран	ʂɐfˈranɨ
шахид	ʂɐˈxʲid
шахиншах	ɕəxʲɪnˈɕax
шахматистка	ʂəxmɐˈtʲistkə
шашка	ˈʂaʂkə
шашлык	ʂɐʂˈɫɨk
швед	ˈʂvʲedɨ
шворень	ˈʂvornʲɪ
шевиот	ʂɨˈvʲjɵtɨ
шедевр	ʂɨˈdɛvrɨ
шейкер	ˈʂɛɪ̯kʲɪr
шек	ʂɛk
шелкография	ʂɨɫ̪kɐˈɡräfʲɪɪ̯ə
шелопуга	ʂəɫɐˈpugə
шелупонь	ʂɨ̞lʊˈpo̞nʲɪ
шельма	ˈʂɛlʲmɨ
шепелявость	ʂɨpʲɪˈlʲavəsʲtʲ
шеренга	ʂɨˈrʲengə
шероховатость	ʂərəxɐˈvatəsʲtʲ
шерсть	ʂɛrsʲtʲ
шест	ʂɪsˈtɨ
шестигранник	ʂɨsʲtʲɪˈgranʲːɪk
шестидневный	ʂəsʲtʲɪˈdnʲevnɨjə
шеф	ʂɛf
шея	ˈʂɛjə
шиит	ʂɨˈit
шимпанзе	ʂɨmpɐnˈzɛ
шина	ˈʂɨnə
широкий	ʂɨˈro̞kʲɪjʂɨˈro̞kəjəʂɨˈro̞kəjə
ширококолейный	ʂɨrəkəkɐˈlʲejnɨj
шитьё	ʂɨˈtʲjɵ
шифер	ˈʂɨfʲɪr
шифр	ʂɨfr
шишига	ʂɨˈʂɨgi
шишка	ˈʂɨʂkə
шкант	ʂkant
шкатулка	ʂkɐˈtuɫkʲɪ
шкаф	ʂkaf
шкафут	ʂkɐˈfut
шкворень	ˈʂkvornʲɪ
школярство	ʂkɐˈlʲærstvə
шкот	ʂkot
шкура	ˈʂkurɨ
шлак	ʂɫak
шлык	ʂɫ̪ɨk
шлюха	ˈʂlʲʉ̞xʲɪ
шлягер	ˈʂlʲægʲɪr
шлямбур	ˈʂlæmbʊr
шляпа	ˈʂlʲæpə
шлях	ʂlʲɪˈxʲiˈʂlʲæxʲɪ
шлёндра	ˈʂlʲɵn̪d̪rɨ
шмель	ʂmʲɪˈlʲi
шмель-плотник	ˈʂmʲelʲɪˈpɫ̪o̞tʲnʲɪkʲɪ
шмон	ʂmo̞n̪
шмотки	ˈʂmot̪kʲɪ
шмурдяк	ʂmʊrˈdʲak
шнобель	ˈʂno̞bʲɪlʲ
шнур	ʂnʊˈrɨ
шобла	ˈʂo̞bɫ̪ɨ
шовинизм	ʂəvʲɪˈnʲizm
шок	ʂok
шорох	ˈʂorəxʲɪ
шоссе	ʂɐˈsːɛ
шоссейник	ʂɐˈsɛjnʲɪk
шотландка	ʂɐtɫand̻kə
шофёр	ʂɐˈfʲɵrɨʂəfʲɪˈra
шоха	ˈʂoxə
шпага	ˈʂpagʲɪ
шпагат	ɕpɐˈgat
шпация	ˈʂpacɨɪ
шпиль	ʂpʲilʲ
шпингалет	ʂpʲɪngɐˈlʲetɨ
шпион	ʂpʲɪˈon
шпионаж	ʂpʲɪɐˈnaʂ
шпор	ˈʂporɨ
шпора	ˈʂporɨ
шпренгель	ˈʂprɛn̻gʲɪlʲɪ
шприц	ˈʂprʲitsɨ
шрам	ˈʂrɑmɨ
шрифт	ˈʂrʲiftɨʂrʲɪfˈtɨ
штаб	ʂt̪ɐˈbɨˈʂt̪äbɨ
штабс-капитан	ʂtɐpskɐpʲɪˈtan
штанга	ˈʂtɑngə
штангенрейсмас	ʂtənɡʲɪˈnrɛjsməs
штанина	ʂtɐˈnʲinɨ
штатив	ʂtɐˈtʲif
штопор	ˈʃtopər
шторм	ʂt̪o̞rm
штормовка	ʂtɐrˈmofkʲɪ
штраф	ʂtraf
штрафстоянка	ʂt̪rəfs̪t̪ɐˈjan̪kɪ
штука	ˈʂtukʲɪ
штукарь	ʂtʊˈkɑrʲ
штурмовик	ʂtʊrmɐˈvʲik
штуцер	ˈʂtutsər
шуба	ˈʂubə
шубохранилище	ˌʂubəxrɐˈnʲilʲɪɕːə
шулер	ˈʂulʲɪr
шумозащита	ʂʊməzɐˈɕːitɨ
шунгизит	ʂʊnɡʲɪˈzʲitɨ
шурин	ˈʂurʲɪn
шуруп	ʂʊˈrupɨ
шустряк	ʂʊsˈtrʲak
шустрячок	ʂʊstrʲɪʲʨok
шут	ʂut̪
шутер	ˈʂut̪ər
шутник	ʂʊt̻ˈnʲik
шухер	ˈʂuxʲɪr
шёлк	ʂoɫk
шёлкопрядение	ʂɛɫkəprʲɪˈdʲenʲɪjə
щегольство	ɕːɪgɐlʲˈs̪t̪vo̞
щедрый	ˈɕːedrɨj
щека	ˈɕːɵ̞kʲɪ
щелчок	ɕːɪɫʨˈkʲi
щенок	ɕːɪnˈkʲi
щербина	ɕːɪrˈbʲinə
щетина	ɕːɪˈtʲinə
щи	ɕːi
щит	ɕːɪˈtɨ
щитовидка	ɕːɪtɐˈvʲitkʲɪ
щоканье	ˈɕːokənʲjɪ
щёлок	ˈɕːɵɫək
эбонит	əbɐˈnʲitɨ
эволюция	ɛvɐˈlʲʉtsɨjə
эвфонический	ɛfːɐˈnʲit͡ɕɪs̪kʲɪj
эгоист	əgɐˈistɨ
эгрет	ɪgˈrɛt
эзотерик	ɛzɐˈtɛrʲɪk
эйчар	ɛɪ̯ˈt͡ɕar
экватор	əkˈvatərɨ
эквилибрист	əkvʲɪlʲɪbˈrʲistɨ
экзальтация	ɪgzʌlʲˈtatsɨ̞jə
экзегеза	eɡz̪ɛˈɡʲez̪ə
экзопланета	ˌɛgzəplɐˈnʲetə
экзотеций	ɛkzɐˈtɛtsɨɪ
эклектичность	ɛklʲɪkˈtʲiʨnəsʲtʲ
эклогит	ɛklɐˈɡʲit
эксгумация	eksɡʊˈmatsɨjə
экситон	ɛksʲɨˈto̞nɨ̞
экскаватор	ɛkskɐˈvɑtərɨ
экскурсовод	ɛkskʊrsɐˈvot
экспедиция	ɪkspʲɪˈdʲitsɨɪ
экспликация	ɛksplʲɪˈkatsɨɪ
экспрессивность	ɛksprʲɪˈsʲːivnəsʲtʲɪ
экстравагантность	ɛkstrəvɐˈɡantnəsʲtʲ
экстраполяция	əkstrəpɐˈlʲætsɨɪ
экстрасенс	ˌɛkstrɐˈsɛnsɨ
экстремист	ɪkstrʲɪˈmist
эксцесс	əksˈtsɛsɨ
элеватор	əlʲɪˈvatərɨ
электровоз	ɛlʲɪkt̻rɐˈvozɨ
электрон	ɪlʲe̞ˈktro̞nɨ̞
электропоезд	ɪlʲəktrɐˈpo̞jɪst
элементаль	ɛlʲɪmʲɪnˈtalʲ
эллипс	ˈɛlʲɪps
эльф	ɛlʲf
эмбрион	ɛmbrʲɪˈon
эмиграция	ɨmʲɪˈgrat͡sɨjə
эмоциональный	ɪmətsɪɐˈnalʲnɨjə
эмпат	ɪmˈpatɨ
эмпириокритицизм	ɪmˌpʲirʲiəkrʲɪtʲɪˈtsɨzm
эму	ˈɛmʊ
эндоэкология	ˌɛn̪d̪ɐˌɛkɐˈɫ̪oɡʲɪɪ̯ɪ
энергия	ɪˈnɛrgʲɪjə
энергопередача	ɪˌnɛrɡəpʲɪrʲɪˈdat͡ɕə
энтузиазм	ɪntʊzʲɪˈazm
энхиридион	ˌɛnxʲɪrʲɪdʲɪˈonɨ
эпидемия	əpʲɪˈdʲemʲɪɪ
эпистолярий	ɛpʲɪstɐˈlʲærʲɪj
эпитет	ɛˈpʲitʲɪtɨ
эполет	ɪpəˈlʲɛtɨ
эпопея	ɪpɐˈpʲeɪ
эпоха	ɪˈpo̞xʲɪ
эпсилон	ˈɛpsʲɪɫənɨ
эрекция	iˈrɛkt͡sɨɪ̯ɪ
эротика	ɪˈrotʲɪkʲɪ
эрэс	ɛrˈɛs̪
эскалатор	əskɐˈɫatərɨ
эскапада	ɛskɐˈpadɨ
эскимо	ɛsʲkʲɪˈmo
эсперанто	ɛspʲɪˈrantə
эспланада	ɛs̪pɫ̪ɐˈn̪ad̪ə
эспума	ɛˈspumə
эта	ˈɛt̪ə
этаж	ɛtɐˈʐɨɪtɐˈʐɨ
этанол	ɛtɐˈnoɫ
этап	ɪˈtapɨ
этика	ˈɛtʲɪkʲɪ
этикетка	ɛtʲɪˈkʲetkə
этимолог	etʲɪmɐˈɫogʲɪ
этимология	ətʲɪmɐˈɫogʲɪjə
этнохороним	ɛt̪n̪əhɐˈro̞nʲɪmɨ
это	ˈɛtʲɪ
этюд	ɪˈtʲʉt
эфес	ɛˈfʲes̪
эшафот	ɛʂɐˈfot
эшель	ɛˈʂɛlʲɪ
эякулят	ɨjɪkʊˈlʲæt
юбилей	jʉbʲɪˈlʲej
юбчонка	jʉpˈʨɵnkʲɪ
ювелир	jʊvʲɪˈlʲir
юдофоб	jʊdɐˈfobɨ
южанин	jʊˈʐanʲɪ
юзверь	ˈjuzvʲɪrʲɪ
юзер	ˈjʉzɨrˈjʉzʲɪr
юмор	ˈjʉmərɨ
юмореска	jʊmɐˈrɛskʲɪjʊmɐˈrʲeskʲɪ
юница	jʊˈnʲitsɨ
юнкер	ʉnkʲɪˈraˈʉnkʲɪrɨ
юстициарий	jʊsʲtʲɪt͡sɨˈarʲɪj
ют	ˈjʉtɨ
яблоко	ˈjæbɫəkə
яблоня	ˈjæbɫənʲɪ
яванец	jɐˈvant͡sɨ
явь	jafʲ
ягдташ	jɪkˈt̪aʂɨ
ягнёнок	jɪgˈnʲætə
ягода	ˈjægədɨ
ягодник	ˈjagəd̻n̻ʲɪk
ягуар	jəgʊˈarɨ
яд	ˈjadɨ
язва	ˈjæzvə
язина	jæzʲɪˈna
язык	jɪˈz̪ɨk
языковед	jɪˌzɨkɐˈvʲed̪ɨ
язычник	jɪˈzɨt͡ɕnʲɪk
язычный	jɪˈzɨt͡ɕnɨj
язь	jæsʲ
яичко	jɪˈitɕkə
яичник	jeˈitɕnɪk
яичница	jɪˈiʂnʲɪtsə
яйцевод	jɪɪ̯t͡sɨˈvodɨ
якобинец	jɪkɐˈbʲinʲɪts
якорь	ˈjækərʲ
ямб	ˈjæmbɨ
ямина	ˈɪ̯jämʲɪn̪ɨ
янбан	jɪnˈbanɨ
январь	jɪnˈvarʲ
янтарь	jɪnˈtarʲ
янычар	jɪnɨˈt͡ɕærɨ
японец	jɪˈpontsɨ
яр	jɪˈrɨˈjærɨ
ярл	ærɫɨ
ярус	ˈjærʊsɨ̞
ярь	ˈjærʲɪ
ястреб	jɪstrʲɪˈbaˈjæstrʲɪbɨ
ятрогения	jɪ̯ɪt̪rɐɡʲɪˈnʲɪɪ
ять	jætʲ
ящер	ˈjæɕːɪr
ящерица	ˈjæɕːɪrʲɪtsɨ
ящерёнок	jæɕːɪˈrʲɵnək
ящик	ˈjæɕːɪk
ёбарь	ˈjobərʲ
ёж	jɪˈʐɨ
ёкай	ˌjɵˈkaɪ̯
ёлочка	ˈjɵɫ̪ət͡ɕkʲɪ
ёрш	jɪrˈʂɨ
